Cell
An Interactive Fiction by Aromie Kim
Release 1 / Serial number 140315 / Inform 7 build 6G60 (I6/v6.32 lib 6/12N) SD

You open your eyes and see nothing but darkness. You try to remember what happened, why you're here, who you are, but thinking alone makes your head throb. Dread and discomfort slowly creeps into your body. You shiver. For some reason, you feel the need to explore. You know you can't just stay here. You need to investigate.

Dark Cell
The air feels oddly heavy. The dark is unsettling. A bed is at the corner. A small window sheds some light so you can navigate around.

A gated door leads north.

A yellow door leads west.

A small table sits beside the bed.

On the table is a candy bar.

>go left
(first opening the bathroom door)
You open the bathroom and almost reel back from the rancid stench.

Bathroom
A dirty bathroom with a putrid smell. You'd rather not stay here for long.

You can see a bathroom door, a toilet and a medicine cabinet (in which are a card and a key) here.

>examine toilet
The water is discolored and the porcelain is nastily yellow. Nothing exciting and nothing you'd like to see.

>examine medicine cabinet
There's a crack in the lower right corner. Within the crack, you can make out a card and a key.

>examine card
You can't see any such thing.

>take card
You can't see any such thing.

* * *

>examine medicine cabinet
There's a crack in the lower right corner. Within the crack, you can make out a card and a key.

>take card
You can't see any such thing.

>examine card
You can't see any such thing.

* * *

>go left
(first opening the bathroom door)
You open the bathroom and almost reel back from the rancid stench.

Bathroom
A dirty bathroom with a putrid smell. You'd rather not stay here for long.

You can see a bathroom door, a toilet and a medicine cabinet (in which are a card and a key) here.

>examine medicine cabinet
The cabinet is ever so slightly ajar.

In the medicine cabinet are a card and a key.

>take card
Taken.

>examine card
A small, dirty, green card. It says the words "ESCAPE NOW" along with the number 11-5-19.

>go east
Dark Cell
The darkness of the room brings some comfort as you open your aching eyes. You struggle to remember what had happened, but your head aches just thinking. The air feels oddly heavy. You can't see much, but you can see a door to your left, and a gated cell door in front of you.

You can see a bathroom door here.

* * *

>take card
Taken.

>take key
Taken.

>examine key
You see nothing special about the key.

>go east
Dark Cell
The air feels oddly heavy. You can't see much, but you can see a door to your left, and a gated cell door in front of you.

You can see a bathroom door here.

>unlock gated cell door
You can't see any such thing.

>open gated cell door
You can't see any such thing.

* * *

>go left
(first opening the bathroom door)
You open the bathroom and almost reel back from the rancid stench.

Bathroom
A dirty bathroom with a putrid smell. You'd rather not stay here for long.

You can see a bathroom door, a toilet and a medicine cabinet (in which are a card and a key) here.

>examine cabinet
The cabinet is ever so slightly ajar.

In the medicine cabinet are a card and a key.

>take card
Taken.

* * *

>take key
Taken.

>go east
Dark Cell
The air feels oddly heavy. You can't see much, but you can see a door to your left, and a gated cell door in front of you.

You can see a bathroom door and a gated cell door here.

>open gated cell door
It's locked.

>unlock gated cell door
It's locked.

* * *

>go left
(first opening the bathroom door)
You open the bathroom and almost reel back from the rancid stench.

Bathroom
A dirty bathroom with a putrid smell. You'd rather not stay here for long.

You can see a bathroom door, a toilet and a medicine cabinet (in which are a card and a key) here.

>take card
Taken.

* * *

>go east
Dark Cell
The air feels oddly heavy. You can't see much, but you can see a door to your left, and a gated cell door in front of you.

You can see a bathroom door and a gated cell door here.

>unlock gated cell door
What do you want to unlock the gated cell door with?

>open gated cell door
It's locked.

>unlock gated cell door
What do you want to unlock the gated cell door with?

>unlocked gated cell door with key
You can't see any such thing.

* * *

>open bathroom door
You open the bathroom door.

>examine card
You can't see any such thing.

>examine toilet
You can't see any such thing.

>go left
Bathroom
A dirty bathroom with a putrid smell. You'd rather not stay here for long.

You can see a bathroom door, a toilet and a medicine cabinet (in which is a card) here.

* * *

>open bathroom door
You open the bathroom door.

>go in
You can't go that way.

>go to bathroom
You can't see any such thing.

>go left
Bathroom
A dirty bathroom with a putrid smell. You'd rather not stay here for long.

You can see a bathroom door, a toilet and a rat here.

* * *

>open bathroom door
You open the bathroom door.

>enter bathroom door
Bathroom
A dirty bathroom with a putrid smell. You'd rather not stay here for long.

You can see a bathroom door, a toilet and a rat here.

>examine toilet
The water is discolored and the porcelain is nastily yellow. Nothing exciting and nothing you'd like to see.

>examine rat
A large rat dozes near the toilet. Something is in its mouth. Maybe you can make it drop it.

>wake rat
The rat squeals and opens its mouth, dropping a card.

>take card
You can't see any such thing.

* * *

>open bathroom door
You open the bathroom door.

>enter bathroom
Bathroom
A dirty bathroom with a putrid smell. You'd rather not stay here for long.

A door with a cracked sign saying "BATHROOM" is at your left.

A nasty toilet sits in the corner.

A rat dozes under the bowl.

The rat appears to be holding something rectangular in its mouth.

>examine rat
Something rectangular is in its mouth. Maybe you can get it to drop it somehow?

>wake rat
The rat squeals and opens its mouth, dropping a card.

>take card
Taken.

* * *

>examine card
A small, dirty, green card. It says the words "ESCAPE NOW" along with the number 11-5-19.

>exit bathroom
I only understood you as far as wanting to exit.

>leave bathroom
I only understood you as far as wanting to leave.

>exit bathroom door
I only understood you as far as wanting to exit.

>go to Dark Cell
You can't see any such thing.

>leave
But you aren't in anything at the moment.

>go west
You can't go that way.

>go east
Dark Cell
The air feels oddly heavy. The dark is unsettling.

A door with a cracked sign saying "BATHROOM" is at your left.

You can also see a gated cell door here.

>open gated cell door
That's already open.

>enter gated cell door
Hallway
A dimly-lit hallway. A white door is before you.

You can see a gated cell door here.

>open white door
You can't see any such thing.

* * *

>enter bathroom
Bathroom
A dirty bathroom with a putrid smell. You'd rather not stay here for long.

A door with a cracked sign saying "BATHROOM" is at your left.

A nasty toilet sits in the corner.

A rat dozes under the bowl.

The rat appears to be holding something rectangular in its mouth.

>examine toilet
The water is discolored and the porcelain is nastily yellow. Nothing exciting and nothing you'd like to see.

>examine rat
Something rectangular is in its mouth. Maybe you can get it to drop it somehow?

* * *

>examine card
A small, dirty, green card. It says the words "ESCAPE NOW" along with the number 11-5-19.

>go west
You can't go that way.

>go east
Dark Cell
The air feels oddly heavy. The dark is unsettling.

A door with a cracked sign saying "BATHROOM" is at your left.

An open, gated door stands before you.

>enter gated door
Hallway
A dimly-lit hallway. There is complete darkness to your left and right.

A white door stands in front of you. A sign on it says "Enter."

An open, gated door stands before you.

>open white door
You open the white door.

>enter
You must supply a noun.

>enter door
Which do you mean, the white door or the gated cell door?

>enter white door
Chamber
A brightly lit room. A small camera hangs nearly thirteen feet above you. The floor is spotless.

A white door stands in front of you. A sign on it says "Enter."

Suddenly, the room echoes with the sound of a tinny voice. "Greetings. You managed to escape your cell. Can you wave your hand to tell me you can hear me?"

>wave hand
You can't see any such thing.

>wave
You wave, feeling foolish.

* * *

>open left door
You have entered the Bathroom.

>open gated cell door
You can't see any such thing.

* * *

>open left door
You have entered the Bathroom.

>examine Bathroom
You can't see any such thing.

* * *

>go front
You can't go that way.

>go north
You can't go that way.

>go left
(first opening the bathroom door)
You open the bathroom and almost reel back from the rancid stench.

Bathroom
A dirty bathroom with a putrid smell. You'd rather not stay here for long.

You can see a bathroom door, a toilet and a medicine cabinet (in which is a card) here.

>examine medicine cabinet
The cabinet is ever so slightly ajar.

In the medicine cabinet is a card.

>take card
Taken.

* * *

>examine card
A small, dirty, green card. It says the words "ESCAPE NOW" along with the number 11-5-19.

>go east
Dark Cell
The air feels oddly heavy. You can't see much, but you can see a door to your left, and a gated cell door in front of you.

You can see a bathroom door here.

* * *

>go left
(first opening the bathroom door)
You open the bathroom and almost reel back from the rancid stench.

Bathroom
A dirty bathroom with a putrid smell. You'd rather not stay here for long.

There is a door to the left.

You can also see a toilet and a medicine cabinet (in which is a card) here.

>examine medicine cabinet
The cabinet is ever so slightly ajar.

In the medicine cabinet is a card.

* * *

>test me
>--> No test scripts exist for this game.

>open bathroom door
You open the bathroom door.

>enter bathroom
Bathroom
A dirty bathroom with a putrid smell. You'd rather not stay here for long.

A nasty toilet sits in the corner.

A rat dozes under the bowl.

The rat appears to be holding something rectangular in its mouth.

You can also see a bathroom door here.

>examine rat
You see nothing special about the rat.

* * *

>test me
>--> No test scripts exist for this game.

>go left
(first opening the bathroom door)

Bathroom
A dirty bathroom with a putrid smell. You'd rather not stay here for long. You can return to the Dark Cell by going right.

A door with a cracked sign saying "BATHROOM" is at your left.

A nasty toilet sits in the corner.

A rat dozes under the bowl.

The rat appears to be holding something rectangular in its mouth.

>examine rat
Something rectangular is in its mouth. Maybe you can get it to drop it somehow?

* * *

>wake rat
The rat squeals and opens its mouth, dropping a card.

>examine card
A small, dirty, green card. It says the words "ESCAPE NOW" along with the number 11-5-19. The name "Sebastian Weaver" is scrawled under it.

>take card
Taken.

>enter Dark Cell
You can't see any such thing.

>enter gated door
You can't see any such thing.

>enter gated cell door
You can't see any such thing.

>go right
Dark Cell
The air feels oddly heavy. The dark is unsettling.

A door with a cracked sign saying "BATHROOM" is at your left.

An open, gated door stands before you.

>enter gated door
Hallway
A dimly-lit hallway. There is complete darkness to your left and right.

An open, gated door stands before you.

You can also see a white door here.

>enter white door
(first opening the white door)
Chamber
A brightly lit room. A small camera hangs nearly thirteen feet above you. The floor is spotless.

You can see a white door and a Voice here.

Suddenly, the room echoes with the sound of a tinny voice. It sounds artificial. "Hello. You managed to escape your cell. Can you give me a greeting so I know that you can hear me?"

>greet voice
"Fantastic. I'll be watching you progress through this place. Now look to your left. You should see a room."

>go left
Equipment Area
The room is entirely trashed. Papers are scattered all over the floor. West is another room, lit in red.

You see some photos that resemble X-rays, but they appear to be burnt.

A deplorable desk is here.

A bedraggled white cat sits snugly on top of a messy desk. A collar is around its neck. It stares at you with beady yellow eyes. The Voice speaks: "That's Sylvester. He's quite a friendly cat. He enjoys a nice touch on the head."

>touch Sylvester
Sylvester seems relaxed and complacent. The collar is right under your hand. Maybe you can take a closer look at it.

>read collar
It has the letters "--MORY LABS." Some letters are blurred out.

[Your score has just gone up by five points.]

>examine desk
Messy beyond belief. Under a lamp, you see words etched onto the surface of the desk: "IS THIS A GAME TO YOU?"

[Your score has just gone up by four points.]

>examine X-ray
The word "Subject 46" is written on the bottom left corner. Upon closer inspection, it looks as if the X-ray is one of a...skull?

>take X-ray
The Voice returns: "The human brain is an amazing thing. But, like most amazing things, it likely should not be probed."

>go west
Red Area
Dozens of photos of men and women alike hang on a wire in the air. To the north you can see an entrance to a brightly lit room.

There is a photo within reach.

Sylvester scampers into the room and looks at you meaningfully. "He seems to take a liking to you," the Voice remarks.

>go east
Equipment Area
The room is entirely trashed. Papers are scattered all over the floor. West is another room, lit in red.

A deplorable desk is here.

A bedraggled white cat sits snugly on top of a messy desk. A collar is around its neck. It stares at you with beady yellow eyes. The Voice speaks: "That's Sylvester. He's quite a friendly cat. He enjoys a nice touch on the head."

>go west
Red Area
Dozens of photos of men and women alike hang on a wire in the air. To the north you can see an entrance to a brightly lit room.

There is a photo within reach.

* * *

>open gated door
That's already open.

>enter gated door
Hallway
A dimly-lit hallway. There is complete darkness to your left and right.

A white door stands in front of you. A sign on it says "Enter."

An open, gated door stands before you.

>enter white door
(first opening the white door)
Chamber
A brightly lit room. A small camera hangs nearly thirteen feet above you. The floor is spotless.

A white door stands in front of you. A sign on it says "Enter."

You can also see a Voice here.

Suddenly, the room echoes with the sound of a tinny voice. "Greetings. You managed to escape your cell. Can you say "Hello" so I know that you can hear me?"

>wave
You wave, feeling foolish.

* * *

>enter white door
(first opening the white door)
Chamber
A brightly lit room. A small camera hangs nearly thirteen feet above you. The floor is spotless.

A white door stands in front of you. A sign on it says "Enter."

You can also see a Voice here.

Suddenly, the room echoes with the sound of a tinny voice. "Greetings. You managed to escape your cell. Can you say "Hello" so I know that you can hear me?"

>greet voice
"Fantastic. I'll be watching you progress through this place. Now look to your left. I've opened a room for you.

>go left
Equipment room
The room is entirely trashed. Papers are scattered all over the floor. West is another room, lit in red.

* * *

>enter gated door
Hallway
A dimly-lit hallway. There is complete darkness to your left and right. North is an open entryway.

An open, gated door stands before you.

>enter white door
(first opening the white door)
Chamber
A brightly lit room. A small camera hangs nearly thirteen feet above you. The floor is spotless.

A white door stands in front of you. A sign on it says "Enter."

You can also see a Voice here.

Suddenly, the room echoes with the sound of a tinny voice. "Greetings. You managed to escape your cell. Can you say "Hello" so I know that you can hear me?"

>greet Voice
"Fantastic. I'll be watching you progress through this place. Now look to your left."

* * *

>greet voice
"Fantastic. I'll be watching you progress through this place. Now look to your left. I've opened a room for you.

>enter gray door
Equipment Area
The room is entirely trashed. Papers are scattered all over the floor. You see some photos that resemble X-rays, but they appear to be burnt.

A bedraggled white cat sits snugly on top of a messy desk. A collar is around its neck. It stares at you with beady yellow eyes. The Voice speaks: "That's Sylvester. He's quite a friendly cat. He enjoys a nice touch on the head."

You can also see a gray door, a X-ray and a desk here.

>examine X-ray
The word "Subject 46" is written on the bottom left corner. Upon closer inspection, it looks as if the X-ray is one of the...skull?

>examine desk
Messy beyond belief. Under a lamp, you see words etched onto the surface of the desk: "IS THIS A GAME TO YOU?"

[Your score has just gone up by four points.]

* * *

>enter gray door
Equipment Area
The room is entirely trashed. Papers are scattered all over the floor. You see some photos that resemble X-rays, but they appear to be burnt.

A bedraggled white cat sits snugly on top of a messy desk. A collar is around its neck. It stares at you with beady yellow eyes. The Voice speaks: "That's Sylvester. He's quite a friendly cat. He enjoys a nice touch on the head."

You can also see a gray door, a X-ray and a desk here.

>touch Sylvester
Sylvester seems relaxed and complacent. The collar is right under your hand.

>take collar
That seems to belong to Sylvester.

>examine collar
It has the letters "--MORY LABS." Some letters are blurred out.

[Your score has just gone up by five points.]

>take X-ray
The Voice returns: "Enjoying the photos? They're quite nice.

>examine X-ray
The word "Subject 46" is written on the bottom left corner. Upon closer inspection, it looks as if the X-ray is one of the...skull?

* * *

>greet voice
"Fantastic. I'll be watching you progress through this place. Now look to your left. I've opened a room for you.

>go left
Equipment Area
The room is entirely trashed. Papers are scattered all over the floor. West is another room, lit in red.

You see some photos that resemble X-rays, but they appear to be burnt.

A deplorable desk is here.

A bedraggled white cat sits snugly on top of a messy desk. A collar is around its neck. It stares at you with beady yellow eyes. The Voice speaks: "That's Sylvester. He's quite a friendly cat. He enjoys a nice touch on the head."

>examine paper
You can't see any such thing.

* * *

>go left
Equipment Area
The room is entirely trashed. Papers are scattered all over the floor. West is another room, lit in red.

You see some photos that resemble X-rays, but they appear to be burnt.

A deplorable desk is here.

A bedraggled white cat sits snugly on top of a messy desk. A collar is around its neck. It stares at you with beady yellow eyes. The Voice speaks: "That's Sylvester. He's quite a friendly cat. He enjoys a nice touch on the head."

>examine room
You can't see any such thing.

>examine desk
You can't see any such thing.

* * *

>go left
Equipment Area
The room is entirely trashed. Papers are scattered all over the floor. West is another room, lit in red.

You see some photos that resemble X-rays, but they appear to be burnt.

A deplorable desk is here.

A bedraggled white cat sits snugly on top of a messy desk. A collar is around its neck. It stares at you with beady yellow eyes. The Voice speaks: "That's Sylvester. He's quite a friendly cat. He enjoys a nice touch on the head."

>go right
You can't see any such thing.

>go east
Chamber
A brightly lit room. A small camera hangs nearly thirteen feet above you. The floor is spotless.

A white door stands in front of you. A sign on it says "Enter."

You can also see a Voice here.

>go left
Equipment Area
The room is entirely trashed. Papers are scattered all over the floor. West is another room, lit in red.

You see some photos that resemble X-rays, but they appear to be burnt.

A deplorable desk is here.

A bedraggled white cat sits snugly on top of a messy desk. A collar is around its neck. It stares at you with beady yellow eyes. The Voice speaks: "That's Sylvester. He's quite a friendly cat. He enjoys a nice touch on the head."

* * *

>touch Sylvester
Sylvester seems relaxed and complacent. The collar is right under your hand. Maybe you can take a closer look at it.

>examine collar
It has the letters "--MORY LABS." Some letters are blurred out.

[Your score has just gone up by five points.]

>examine desk
Messy beyond belief. Under a lamp, you see words etched onto the surface of the desk: "IS THIS A GAME TO YOU?"

[Your score has just gone up by four points.]

* * *

>examine X-ray
The word "Subject 46" is written on the bottom left corner. Upon closer inspection, it looks as if the X-ray is one of a...skull?

>take X-ray
The Voice returns: "Enjoying the photos? They're quite nice.

>go west
Red Area
Dozens of photos of men and women alike hang on a wire in the air.

There is a photo within reach.

Sylvester scampers into the room and looks at you meaningfully. "He seems to take a liking to you," the Voice remarks.

>examine photo
This photo shows two people sitting at a table in a simple room. One person wears a white coat, his back to the camera. The other, a middle-aged woman, stares at him with an unnaturally blank look. On the bottom of the photo is a message: "Subject 46: Exhibiting failure to comprehend."

[Your score has just gone up by five points.]

* * *

>examine X-ray
The word "Subject 46" is written on the bottom left corner. Upon closer inspection, it looks as if the X-ray is one of a...skull?

>take X-ray
The Voice returns: "Enjoying the photos? They're quite nice."

>go west
Red Area
Dozens of photos of men and women alike hang on a wire in the air. To the right you can see an entrance to a brightly lit room.

There is a photo within reach.

Sylvester scampers into the room and looks at you meaningfully. "He seems to take a liking to you," the Voice remarks.

>take photo
Taken.

>examine photo
This photo shows two people sitting at a table in a simple room. One person wears a white coat, his back to the camera. The other, a middle-aged woman, stares at him with an unnaturally blank look. On the bottom of the photo is a message: "Subject 46: Exhibiting failure to comprehend."

[Your score has just gone up by five points.]

>go right
You can't see any such thing.

>go east
Equipment Area
The room is entirely trashed. Papers are scattered all over the floor. West is another room, lit in red.

A deplorable desk is here.

A bedraggled white cat sits snugly on top of a messy desk. A collar is around its neck. It stares at you with beady yellow eyes. The Voice speaks: "That's Sylvester. He's quite a friendly cat. He enjoys a nice touch on the head."

>go west
Red Area
Dozens of photos of men and women alike hang on a wire in the air. To the right you can see an entrance to a brightly lit room.

>go east
Equipment Area
The room is entirely trashed. Papers are scattered all over the floor. West is another room, lit in red.

A deplorable desk is here.

A bedraggled white cat sits snugly on top of a messy desk. A collar is around its neck. It stares at you with beady yellow eyes. The Voice speaks: "That's Sylvester. He's quite a friendly cat. He enjoys a nice touch on the head."

* * *

>go west
Red Area
Dozens of photos of men and women alike hang on a wire in the air. To the right you can see an entrance to a brightly lit room.

>go west
You can't go that way.

>go south
You can't go that way.

>go north
Lab
The room is huge and brightly lit. To the left is a heavy, locked door that says "DO NOT ENTER."

A series of cages line the walls, all open.

There is a small, hand-crafted, wooden maze on a table.

You can also see a heavy door and a cabinet (in which is a key) here.

Sylvester hisses and begins to pace actively around the room

>examine heavy door
It's locked shut and is quite heavy. "Brilliant scientists, but dumb as an acorn. They say most fools don't keep a key more than 20 feet away from where the door is," the Voice speaks, somewhat dryly.

>examine cage
Looking into some cages, you see tufts of different fur inside. Were they from different animals?

>examine cabinet
In the cabinet is a key.

* * *

>enter white door
(first opening the white door)
Chamber
A brightly lit room. A small camera hangs nearly thirteen feet above you. The floor is spotless.

A white door stands in front of you. A sign on it says "Enter."

You can also see a Voice here.

Suddenly, the room echoes with the sound of a tinny voice. "Greetings. You managed to escape your cell. Can you say "Hello" so I know that you can hear me?"

>go left
Equipment Area
The room is entirely trashed. Papers are scattered all over the floor. West is another room, lit in red.

You see some photos that resemble X-rays, but they appear to be burnt.

A deplorable desk is here.

A bedraggled white cat sits snugly on top of a messy desk. A collar is around its neck. It stares at you with beady yellow eyes. The Voice speaks: "That's Sylvester. He's quite a friendly cat. He enjoys a nice touch on the head."

>go west
Red Area
Dozens of photos of men and women alike hang on a wire in the air. To the north you can see an entrance to a brightly lit room.

There is a photo within reach.

Sylvester scampers into the room and looks at you meaningfully. "He seems to take a liking to you," the Voice remarks.

>go north
Lab
The room is huge and brightly lit.

To the left is a heavy, locked door that says "DO NOT ENTER." You can hear something behind it: is that breathing?

A series of cages line the walls, all open.

There is a small, hand-crafted, wooden maze on a table.

A black cabinet stands near the table.

A cockroach sits placidly on the cabinet surface.

Sylvester hisses and begins to pace actively around the room

>examine cabinet
You see nothing special about the cabinet.

>open cabinet
You found the key!

* * *

>go north
Lab
The room is huge and brightly lit.

To the left is a heavy, locked door that says "DO NOT ENTER." You can hear something behind it: is that breathing?

A series of cages line the walls, all open.

There is a small, hand-crafted, wooden maze on a table.

A black cabinet stands near the table.

A cockroach sits placidly on the cabinet surface.

Sylvester hisses and begins to pace actively around the room

>examine heavy door
It's locked shut and is quite heavy. "Brilliant scientists, but dumb as an acorn. They say most fools don't keep a key more than 20 feet away from where the door is," the Voice speaks, somewhat dryly.

>examine cabinet
You see nothing special about the cabinet.

>open cabinte
You can't see any such thing.

>open cabinet
You found the key! "Well done," the Voice praises.

>unlock heavy door
What do you want to unlock the heavy door with?

>unlock heavy door with key
(first taking the key)
You unlocked it!

>enter heavy door
(first opening the heavy door)
It seems to be locked.

* * *

>go north
Lab
The room is huge and brightly lit.

To the left is a heavy, locked door that says "DO NOT ENTER." You can hear something behind it: is that breathing?

A series of cages line the walls, all open.

There is a small, hand-crafted, wooden maze on a table.

A black cabinet stands near the table.

A cockroach sits placidly on the cabinet surface.

Sylvester hisses and begins to pace actively around the room

>examine cockroach
Ew. You'd rather not touch the cabinet with that thing running around. "Didn't think THAT would stop you," the Voice remarks.

>examine cabinet
You see nothing special about the cabinet.

>open cabinet
You found the key! "Well done," the Voice praises. "Take the key and you should be able to go on your way."

>kill cockroach
Violence isn't the answer to this one.

>squash cockroach
You smash the cockroach with your foot. The cabinet is safe for observation!

>take key
Taken.

>unlock heavy door with key
You unlocked the door!

>enter heavy door
(first opening the heavy door)
It seems to be locked.

* * *

>examine cockroach
Ew. You'd rather not touch the cabinet with that thing running around. "Didn't think THAT would stop you," the Voice remarks.

>squash cockroach
You smash the cockroach with your foot. The cabinet is safe for observation!

>examine cabinet
You see nothing special about the cabinet.

* * *

>open cabinet
You found the key! "Well done," the Voice praises. "Take the key and you should be able to go on your way."

>take key
Taken.

>unlock heavy door
You unlock the heavy door.

>enter heavy door
(first opening the heavy door)

Experimental Room
An intimidatingly large chair sits in the center of the room. The walls are adorned with pictures of words and drawings of random objects, from houses to animals.

To the left is a heavy, locked door that says "DO NOT ENTER." You can hear something behind it: is that breathing?

* * *

>go north
Lab
The room is huge and brightly lit.

To the left is a heavy, locked door that says "DO NOT ENTER." You can hear something behind it: is that breathing?

A series of cages line the walls, all open.

There is a small, hand-crafted, wooden maze on a table.

A black cabinet stands near the table.

A cockroach sits placidly on the cabinet surface.

Sylvester hisses and begins to pace actively around the room

>go left
Equipment Area
The room is entirely trashed. Papers are scattered all over the floor. West is another room, lit in red.

You see some photos that resemble X-rays, but they appear to be burnt.

A deplorable desk is here.

A bedraggled white cat sits snugly on top of a messy desk. A collar is around its neck. It stares at you with beady yellow eyes. The Voice speaks: "That's Sylvester. He's quite a friendly cat. He enjoys a nice touch on the head."

>go west
Red Area
Dozens of photos of men and women alike hang on a wire in the air. To the north you can see an entrance to a brightly lit room.

There is a photo within reach.

>go north
Lab
The room is huge and brightly lit.

To the left is a heavy, locked door that says "DO NOT ENTER." You can hear something behind it: is that breathing?

A series of cages line the walls, all open.

There is a small, hand-crafted, wooden maze on a table.

A black cabinet stands near the table.

A cockroach sits placidly on the cabinet surface.

>take key
You can't see any such thing.

>open cabinet
You found the key! "Well done," the Voice praises. "Take the key and you should be able to go on your way."

* * *

>unlock heavy door
You unlock the heavy door.

>enter heavy door
(first opening the heavy door)

Experimental Room
An intimidatingly large chair sits in the center of the room. The walls are adorned with pictures of words and drawings of random objects, from houses to animals.

To the left is a heavy, locked door that says "DO NOT ENTER." You can hear something behind it: is that breathing?

You realize the quiet breathing is from a man sitting in the chair. He does not look at you and wears a blank expression.

>examine man
A document and photograph are crumpled in the Stranger's hand.

>examine document
It's an official document: "SUBJECT NAME: 14 (John Akins) Age: 43 Length of Stay: 10 months
 Subject 14 arrived at the facility as a healthy middle-aged male with average memory skills. He performed well in the maze tasks and made few errors in recollection games. After being subjected to the treatment, Subject 14 exhibited gradual memory deterioration, as expected, but at a slower rate than the animals. He made errors in the mazes that he had been trained to do for months. By month 4, his short-term memory worsened to a time capacity of roughly 13 seconds. He struggled in recognizing the faces of his experimenters. By month 7, he failed to recognize a photo of himself, as well as his family members. By month 9, he fiercely demanded to be let out of the facility. We tacitly refused. There is a reason why the experiment went awry, and he is a valuable subject in our attempts to fix the issue. For the moment, we will ask him to continue his participation in the memory tasks."

>examine photograph
A crumpled photo of the man (looking considerably younger), a woman, and a child at what seems to be a beach. They are all smiling.

* * *

>go north
Lab
The room is huge and brightly lit.

To the left is a heavy, locked door that says "DO NOT ENTER." You can hear something behind it: is that breathing?

A series of cages line the walls, all open.

There is a small, hand-crafted, wooden maze on a table.

A black cabinet stands near the table.

A cockroach sits placidly on the cabinet surface.

Sylvester hisses and begins to pace actively around the room

>enter heavy door
(first opening the heavy door)
It seems to be locked.

>open cabinet
You found the key! "Well done," the Voice praises. "Take the key and you should be able to go on your way."

* * *

>enter heavy door
(first opening the heavy door)
It seems to be locked.

* * *

>go left
Equipment Area
The room is entirely trashed. Papers are scattered all over the floor. West is another room, lit in red.

You see some photos that resemble X-rays, but they appear to be burnt.

A deplorable desk is here.

A bedraggled white cat sits snugly on top of a messy desk. A collar is around its neck. It stares at you with beady yellow eyes. The Voice speaks: "That's Sylvester. He's quite a friendly cat. He enjoys a nice touch on the head."

>go north
You can't go that way.

>go west
Red Area
Dozens of photos of men and women alike hang on a wire in the air. To the north you can see an entrance to a brightly lit room.

There is a photo within reach.

Sylvester scampers into the room and looks at you meaningfully. "He seems to take a liking to you," the Voice remarks.

* * *

>enter heavy door
(first opening the heavy door)

Experimental Room
An intimidatingly large chair sits in the center of the room. The walls are adorned with pictures of words and drawings of random objects, from houses to animals.

To the left is a heavy, locked door that says "DO NOT ENTER." You can hear something behind it: is that breathing?

You realize the quiet breathing is from a man sitting in the chair. He does not look at you and wears a blank expression.

>examine drawing
You can't see any such thing.

>examine photograph
You can't see any such thing.

>examine man
A document and photograph are crumpled in the man's hand.

>examine photograph
A crumpled photo of the man (looking considerably younger), a woman, and a child at what seems to be a beach. They are all smiling. 
 "Beautiful family," the Voice says quietly. "It's upsetting he forgot them all."

[Your score has just gone up by three points.]

* * *

>enter gated door
Hallway
A dimly-lit hallway. There is complete darkness to your left and right. North is an open entryway.

An open, gated door stands before you.

>enter white dor
I only understood you as far as wanting to enter the white door.

>enter white door
(first opening the white door)
Chamber
A brightly lit room. A small camera hangs nearly thirteen feet above you. The floor is spotless.

The camera beeps to life.

You can also see a white door here.

Suddenly, the room echoes with the sound of a tinny voice. It sounds artificial. "Hello. You managed to escape your cell. Well done. Can you give me a greeting so I know that you can hear me?"

>greet voice
"Fantastic. I'll be watching you progress through this place. Now go to your left."

>go left
Equipment Area
The room is entirely trashed. Papers are scattered all over the floor. West is another room, lit in red.

You see some photos that resemble X-rays, but they appear to be burnt.

A deplorable desk is here.

You can also see Sylvester here.

>examine cat
You can't see any such thing.

>examine Sylveser
You can't see any such thing.

>touch Sylvester
Sylvester seems relaxed and complacent. The collar is right under your hand. Maybe you can take a closer look at it.

>examine collar
It has the letters "--MORY LABS." Some letters are blurred out. The initials "S.W." are scrawled on it.

[Your score has just gone up by five points.]

>go west
Red Area
Dozens of photos of men and women alike hang on a wire in the air. To the north you can see an entrance to a brightly lit room.

There is a photo within reach.

Sylvester scampers into the room and looks at you meaningfully. "He seems to take a liking to you," the Voice remarks.

>examine photo
This photo shows two people sitting at a table in a simple room. One person wears a white coat, his back to the camera. The other, a middle-aged woman, stares at him with an unnaturally blank look. On the bottom of the photo is a message: "Subject 46: Exhibiting failure to recognize her experimenter of 10 months."

[Your score has just gone up by five points.]

>go north
Lab
The room is huge and brightly lit. If you stay quiet, you can hear muffled breathing coming from somewhere...

A series of cages line the walls, all open.

There is a small, hand-crafted, wooden maze on a table.

A black cabinet stands near the table.

A cockroach sits placidly on the cabinet surface.

You can also see a heavy door here.

Sylvester hisses and begins to sniff eagerly at the cages

>examine cages
You can't see any such thing.

>examine cage
Looking into some cages, you see tufts of different fur inside. Were they from different animals?

[Your score has just gone up by three points.]

>examine cabinet
You see nothing special about the cabinet.

>examine black cabinet
You can't see any such thing.

>examine cockroach
Ew. You'd rather not touch the cabinet with that thing running around. "Didn't think THAT would stop you," the Voice remarks.

>kill cockroach
You smash the cockroach with your foot. You feel safe enough to touch the cabinet.

>open cabinet
You found the key! "Well done," the Voice praises. "Take the key and you should be able to go on your way."

* * *

>take key
Taken.

>examine heavy door
It's locked shut and is quite heavy. "Brilliant scientists, but dumb as an acorn. They say most fools don't keep a key more than 20 feet away from where the door is," the Voice speaks, somewhat dryly.

>unlock heavy door
You unlock the heavy door.

>enter heavy door
(first opening the heavy door)

Experimental Room
An intimidatingly large chair sits in the center of the room. The walls are adorned with pictures of words and drawings.

You realize the quiet breathing from before is from a man sitting in the chair. He does not look at you and wears a blank expression.

One drawing is not of an object or person.

You can also see a heavy door here.

>examine drawing
You examine a drawing of a map. It looks to be a map of where you are. Tally marks are drawn under the map in pencil, along with the words "Sebastian Weaver". "That's the map of this facility," the Voice explains. "As you can see, it's not very big. It's rather obscure. Which is what they wanted." You wonder who Sebastian Weaver is.

>examine man
A document and photograph are crumpled in the man's hand.

>examine document
It's an official document: " SOMA MEMORY LABS 
143-21 East Drive, SC, CA 
 Date: June 10, 2013 
SUBJECT NAME: 14 (John Akins) 
Age: 43 
Length of Stay: 10 months
 
Subject 14 arrived at the facility as a healthy middle-aged male with average memory skills. He performed well in the maze tasks and made few errors in recollection games. 
After being subjected to the treatment, Subject 14 exhibited gradual memory deterioration, as expected, but at a slower rate than the animals. He made errors in the mazes that he had been trained to do for months. 
By month 4, his short-term memory worsened to a time capacity of roughly 13 seconds. He struggled in recognizing the faces of his experimenters. 
By month 7, he failed to recognize a photo of himself, as well as his family members. 
By month 9, he fiercely demanded to be let out of the facility. We tacitly refused. There is a reason why the experiment went awry, and he is a valuable subject in our attempts to fix the issue. We've been working for years on this project; it's preposterous that the outcome completely counters our goals. For the moment, we will ask him to continue his participation in the memory tasks. Perhaps we may have to expand the types of tasks our subjects perform to get to the heart of the issue."

>examine photograph
A crumpled photo of the man (looking considerably younger), a woman, and a child at what seems to be a beach. They are all smiling. 
 "Beautiful family," the Voice says quietly. "It's upsetting he forgot them all."

[Your score has just gone up by three points.]

>examine drawing
You examine a drawing of a map. It looks to be a map of where you are. Tally marks are drawn under the map in pencil, along with the words "Sebastian Weaver". "That's the map of this facility," the Voice explains. "As you can see, it's not very big. It's rather obscure. Which is what they wanted." You wonder who Sebastian Weaver is.

>go north
Maze Room
Giant white walls. It's almost like a human-sized maze...except there are giant holes made in the white walls. Some blood disturbs the white.

Graffiti lines the walls. It looks as if different people had written haphazardly on them.

"It's funny," the Voice muses. "They had to do this damn maze all the time and always complained that they wanted to just get out...it took them a while to figure out that they could just break down the walls. They always had the chance to escape." 
 Sylvester walks through the maze with ease and steps over a folder on the ground.

>examine graffiti
Much of the graffiti are angry messages: "WE'RE NOT RATS" 
 "YOU MAY MAKE ME FORGET MYSELF, BUT I WON'T FORGET YOUR FACES"

Sylvester walks through the maze with ease and carelessly steps over a tattered folder on the ground.

>take folder
Taken.

>read folder
It contains a bunch of important looking papers. One in particular stands out: "
 Subject 11519 has been exhibiting the same kind of behavior ever since his treatment. He has been traversing the entire facility, each and every room. Whenever he reaches the Experimental room, he marks the map with a tally mark and his initials. 
 The subject had entered the facility as a young man who suffered from severe depression. He came after we advertised under the new motto that the military had told us to take on: "New memory therapy for your mental health." His consent form reveals that his motive for joining our project was to "Be happier." Memory loss can assist this, but we did not reveal to him the grave turnabout of our experiments, the fact that our research was meant to completely annihilate the capability to remember at all. 
 But Subject 11519 persists in his travels. He has indeed exhibited memory deterioration, mostly in the form of amnesiac episodes, but he still walks through the facility, makes his marks, and returns to his cell. He does not want to forget. His supervising experimenter, Dr. John Parr, is interested in his antics and insists that we do not interfere. It's worth noting that he has been acting oddly recently; he does not seem enthusiastic and prefers to keep to himself. If 11519"s behavior begins to pester our research, then we will act accordingly. But for the moment, we will let him be. 
 Note: Humorously enough, he has a travel partner. The damn cat that always manages to escape before we can do anything to him. Perhaps they are both attempting to rebel against us?"

"You've been doing well," the Voice suddenly spoke. It sounds quieter than usual. "Can you do me a favor? There is a room up ahead at the end of the maze. Can you go there?"

>go north
"You see an ajar gray door. "Go in," the Voice murmurs.

>enter gray door
You can't see any such thing.

>enter door
You can't see any such thing.

* * *

>enter gated door
Hallway
A dimly-lit hallway. There is complete darkness to your left and right. North is an open entryway.

An open, gated door stands before you.

>go north
Research Room
A large room half-lit with flickering fluorescent lights. There are photos of men and women on the walls. A map of the human brain.

A drawer compartment sits on the floor.

A diary sits on top of a cracked table. "Give it a read." The Voice sounded pained.

>greet voice
"Fantastic. I'll be watching you progress through this place. Now go to your left."

>go left
Equipment Area
The room is entirely trashed. Papers are scattered all over the floor. West is another room, lit in red.

You see some photos that resemble X-rays, but they appear to be burnt.

A deplorable desk is here.

You can also see Sylvester here.

A bedraggled white cat sits snugly on top of a messy desk. A collar is around its neck. It stares at you with beady yellow eyes. The Voice speaks: "That's Sylvester. He's quite a friendly cat. He enjoys a nice touch on the head."

>touch Sylvester
Sylvester seems relaxed and complacent. The collar is right under your hand. Maybe you can take a closer look at it.

>go north
You can't go that way.

* * *

>go north
Lab
The room is huge and brightly lit. If you stay quiet, you can hear muffled breathing coming from somewhere...

A series of cages line the walls, all open.

There is a small, hand-crafted, wooden maze on a table.

A black cabinet stands near the table.

A cockroach sits placidly on the cabinet surface.

You can also see a heavy door here.

Sylvester hisses and begins to sniff eagerly at the cages

>examine wooden maze
It doesn't look too hard to solve. It's just the right size for a small animal.

>enter heavy door
(first opening the heavy door)
It seems to be locked.

>unlock heavy door with key
You can't see any such thing.

>open cabinet
A key is inside! "Well done," the Voice praises. "Take the key and you should be able to go on your way."

>take key
Taken.

* * *

>unlock heavy door
You unlock the heavy door.

>enter heavy door
(first opening the heavy door)

Experimental Room
An intimidatingly large chair sits in the center of the room. The walls are adorned with pictures of words and drawings. Up ahead is an entryway...its door almost completely shattered.

One drawing is not of an object or person.

You realize the quiet breathing from before is from a man sitting in the chair. He does not look at you and wears a blank expression.

You can also see a heavy door here.

>enter heavy door
Lab
The room is huge and brightly lit. If you stay quiet, you can hear muffled breathing coming from somewhere...

A series of cages line the walls, all open.

There is a small, hand-crafted, wooden maze on a table.

A black cabinet stands near the table.

A cockroach sits placidly on the cabinet surface.

You can also see a heavy door here.

>enter heavy door
Experimental Room
An intimidatingly large chair sits in the center of the room. The walls are adorned with pictures of words and drawings. Up ahead is an entryway...its door almost completely shattered.

One drawing is not of an object or person.

You realize the quiet breathing from before is from a man sitting in the chair. He does not look at you and wears a blank expression.

You can also see a heavy door here.

>go north
Maze Room
Giant white walls. It's almost like a human-sized maze...except there are giant holes made in the white walls. Some blood disturbs the white.

Graffiti lines the walls. It looks as if different people had written haphazardly on them.

"It's funny," the Voice muses. "They had to do this damn maze all the time and always complained that they wanted to just get out...it took them a while to figure out that they could just break down the walls. They always had the chance to escape." 
 Sylvester walks through the maze with ease and steps over a folder on the ground.

* * *

>take folder
Taken.

>examine folder
It contains a bunch of important looking papers. One in particular stands out: "
 Subject 11519 has been exhibiting the same kind of behavior ever since his treatment. He has been traversing the entire facility, each and every room. Whenever he reaches the Experimental room, he marks the map with a tally mark and his initials. 
 The subject had entered the facility as a young man who suffered from severe depression. He came after we advertised under the new motto that the military had told us to take on: "New memory therapy for your mental health." His consent form reveals that his motive for joining our project was to "Be happier." Memory loss can assist this, but we did not reveal to him the grave turnabout of our experiments, the fact that our research was meant to completely annihilate the capability to remember at all. 
 But Subject 11519 persists in his travels. He has indeed exhibited memory deterioration, mostly in the form of amnesiac episodes, but he still walks through the facility, makes his marks, and returns to his cell. He does not want to forget. His supervising experimenter, Dr. John Parr, is interested in his antics and insists that we do not interfere. It's worth noting that he has been acting oddly recently; he does not seem enthusiastic and prefers to keep to himself. If 11519"s behavior begins to pester our research, then we will act accordingly. But for the moment, we will let him be. 
 Note: Humorously enough, he has a travel partner. The damn cat that always manages to escape before we can do anything to him. Perhaps they are both attempting to rebel against us?"

"You've been doing well," the Voice suddenly spoke. It sounds quieter than usual. "Can you do me a favor? There is a room up ahead at the end of the maze. Once you're done exploring this area, can you go there?"

>go north
You see an ajar gray door. "Go in," the Voice murmurs.

>enter gray door
You can't see any such thing.

>go north
You can't go that way.

>go south
Maze Room
Giant white walls. It's almost like a human-sized maze...except there are giant holes made in the white walls. Some blood disturbs the white.

Graffiti lines the walls. It looks as if different people had written haphazardly on them.

>go north
You see an ajar gray door. "Go in," the Voice murmurs.

>go north
You can't go that way.

>go east
Exit
A dark room. The right wall is covered with numerous televisions, each depicting a room you have explored.

* * *

>enter bathroom door
(first opening the bathroom door)

Bathroom
A dirty bathroom with a putrid smell. You'd rather not stay here for long. You can return to the Dark Cell by going right.

A nasty toilet sits in the corner.

A rat dozes under the bowl.

The rat appears to be holding something rectangular in its mouth.

You can also see a bathroom door here.

>examine rat
Something rectangular is in its mouth. Maybe you can get it to drop it somehow?

* * *

>examine card
A small, dirty, green card. It says the words "ESCAPE NOW" along with the number 11-5-19. The name "Sebastian Weaver" is scrawled under it.

>go right
Dark Cell
The air feels oddly heavy. The dark is unsettling.

An open, gated door stands before you.

You can also see a bathroom door here.

>enter gated door
Hallway
A dimly-lit hallway. There is complete darkness to your left and right. North is an open entryway.

An open, gated door stands before you.

>go north
Chamber
A brightly lit room. A small camera hangs nearly thirteen feet above you. The floor is spotless.

The camera beeps to life.

Suddenly, the room echoes with the sound of a tinny voice. It sounds artificial. "Hello. You finally woke up, I see. Well done. Can you give me a greeting so I know that you can hear me?"

>greet voice
"Fantastic. I'll be watching you progress through this place. Now go to your left."

>go left
Equipment Area
The room is entirely trashed. Papers are scattered all over the floor. West is another room, lit in red.

You see some photos that resemble X-rays, but they appear to be burnt.

A deplorable desk is here.

A bedraggled white cat sits snugly on top of a messy desk. A collar is around its neck. It stares at you with beady yellow eyes. The Voice speaks: "That's Sylvester. He's quite a friendly cat. He enjoys a nice touch on the head."

>examine desk
Messy beyond belief. Under a lamp, you see words etched onto the surface of the desk: "IS THIS A GAME TO YOU?"

[Your score has just gone up by four points.]

>touch Sylvester
Sylvester seems relaxed and complacent. The collar is right under your hand. Maybe you can take a closer look at it.

* * *

>examine wooden maze
It doesn't look too hard to solve. It's just the right size for a small animal.

>examine cage
Looking into some cages, you see tufts of different fur inside. Were they from different animals?

[Your score has just gone up by three points.]

>open cabinet
A key is inside! "Well done," the Voice praises. "Take the key and you should be able to go on your way."

* * *

>take key
Taken.

>unlock heavy door with key
You unlock the heavy door.

>enter
You must supply a noun.

>enter heavy door
(first opening the heavy door)

Experimental Room
An intimidatingly large chair sits in the center of the room. The walls are adorned with pictures of words and drawings. Up ahead is an entryway...its door almost completely shattered.

One drawing is not of an object or person.

You realize the quiet breathing from before is from a man sitting in the chair. He does not look at you and wears a blank expression.

You can also see a heavy door here.

>examine man
A document and photograph are crumpled in the man's hand.

>read document
It's an official document: " SOMA MEMORY LABS 
143-21 East Drive, SC, CA 
 Date: June 10, 2013 
SUBJECT NAME: 14 (John Akins) 
Age: 43 
Length of Stay: 10 months
 
Subject 14 arrived at the facility as a healthy middle-aged male with average memory skills. He performed well in the maze tasks and made few errors in recollection games. 
After being subjected to the treatment, Subject 14 exhibited gradual memory deterioration, as expected, but at a slower rate than the animals. He made errors in the mazes that he had been trained to do for months. 
By month 4, his short-term memory worsened to a time capacity of roughly 13 seconds. He struggled in recognizing the faces of his experimenters. 
By month 7, he failed to recognize a photo of himself, as well as his family members. 
By month 9, he fiercely demanded to be let out of the facility. We tacitly refused. There is a reason why the experiment went awry, and he is a valuable subject in our attempts to fix the issue. We've been working for years on this project; it's preposterous that the outcome completely counters our goals. For the moment, we will ask him to continue his participation in the memory tasks. Perhaps we may have to expand the types of tasks our subjects perform to get to the heart of the issue. I heard of a suggestion for a human-sized maze. Interesting proposition."

>examine photo
You can't see any such thing.

>examine photograph
A crumpled photo of the man (looking considerably younger), a woman, and a child at what seems to be a beach. They are all smiling. 
 "Beautiful family," the Voice says quietly. "It's upsetting he forgot them all."

[Your score has just gone up by three points.]

>go north
Maze Room
Giant white walls. It's almost like a human-sized maze. Some blood disturbs the white.

Graffiti lines the walls. It looks as if different people had written haphazardly on them.

"It's funny," the Voice muses. "They had to do this damn maze all the time and always complained that they wanted to just get out...it took them a while to figure out that they could just break down the walls. They always had the chance to escape." 
 Sylvester walks through the maze with ease and steps over a folder on the ground.

>examine graffiti
Much of the graffiti are angry messages: "WE'RE NOT RATS" 
 "YOU MAY MAKE ME FORGET MYSELF, BUT I WON'T FORGET YOUR FACES"

Sylvester walks through the maze with ease and carelessly steps over a tattered folder on the ground.

* * *

>take folder
Taken.

>examine folder
It contains a bunch of important looking papers. One in particular stands out: "
 Subject 11519 has been exhibiting the same kind of behavior ever since his treatment. He has been traversing the entire facility, each and every room. Whenever he reaches the Experimental room, he marks the map with a tally mark and his initials. 
 The subject had entered the facility as a young man who suffered from severe depression. He came after we advertised under the new motto that the military had told us to take on: "New memory therapy for your mental health." His consent form reveals that his motive for joining our project was to "Be happier." Memory loss can assist this, but we did not reveal to him the grave turnabout of our experiments, the fact that our research was meant to completely annihilate the capability to remember at all. 
 But Subject 11519 persists in his travels. He has indeed exhibited memory deterioration, mostly in the form of amnesiac episodes, but he still walks through the facility, makes his marks, and returns to his cell. He does not want to forget. His supervising experimenter, Dr. John Parr, is interested in his antics and insists that we do not interfere. It's worth noting that he has been acting oddly recently; he does not seem enthusiastic and prefers to keep to himself. If 11519"s behavior begins to pester our research, then we will act accordingly. But for the moment, we will let him be. 
 Note: Humorously enough, he has a travel partner. The damn cat that always manages to escape before we can do anything to him. Perhaps they are both attempting to rebel against us?"

"You've been doing well," the Voice suddenly spoke. It sounds quieter than usual. "There is a room up ahead at the end of the maze. Once you're done exploring this area, can you walk through the holes and get to the end of the maze?"

>walk through hole
You can't see any such thing.

>walk through holes
You can't see any such thing.

* * *

>go north
Hallway
A dimly-lit hallway. There is complete darkness to your left and right and you feel a chill at the unsettling emptiness. North is an open entryway.

A gated door leads to the Dark Cell.

>go north
Chamber
A brightly lit room that is white as snow. A large TV sits in the corner, along with a few chairs. Some coffee tables sit nearby. A small camera hangs nearly thirteen feet above you. The floor is spotless.

The camera beeps to life. It swivels and points down to you. You see the lens readjusting, focusing.

Suddenly, the room echoes with the sound of a tinny voice. It sounds somewhat muffled, hidden behind an artificial tone. "Hello. You finally woke up, I see. Hope you had adequate sleep. Can you give me a greeting so I know that you can hear me?"

>greet voice
The camera whirs. "Fantastic. I'll be watching you progress through this place. You want to explore, no? Now go to your left. There's a room there."

>go left
Equipment Area
The room is entirely trashed. Papers are scattered all over the gray floor. Westward you can see another room, lit in an ominous red color.

You see some photos that resemble X-rays, but they appear to be burnt.

A deplorable desk is here.

A bedraggled white cat sits snugly on top of a messy desk. A collar is around its neck. It stares at you with beady yellow eyes. 
"That's Sylvester." You jump, startled, as you hear the artificial Voice echo in the room you're in. "He's quite a friendly cat. He enjoys a nice touch on the head."

On the ground there is a fallen clipboard with some ripped pages.

>examine Sylvester
You see nothing special about Sylvester.

>examine cat
You can't see any such thing.

>touch Sylvester
Sylvester seems relaxed and complacent. The collar is right under your hand. Maybe you can take a closer look at it.

* * *

>examine collar
It has the letters "--MORY LABS." Some letters are blurred out. The initials "S.W." are scrawled on it.

[Your score has just gone up by five points.]

>go north
You can't go that way.

* * *

>examine photo
This photo shows two people sitting at a table in a simple room. One person wears a white coat, his back to the camera. The other, a middle-aged woman, stares at him with an unnaturally blank look. On the bottom of the photo is a message: "Subject 46: Exhibiting failure to recognize her experimenter of 10 months."

[Your score has just gone up by five points.]

>go north
Lab
The room is huge and brightly lit. If you stay quiet, you can hear muffled breathing coming from somewhere...

Nearby a heavy door leads east.

A series of cages line the walls, all open.

There is a small, hand-crafted, wooden maze on a table.

A black cabinet stands near the table.

A cockroach sits placidly on the cabinet surface.

Sylvester hisses and begins to sniff eagerly at the cages

>open cabinet
A key is inside! "Well done," the Voice praises. "Take the key and you should be able to go on your way."

* * *

>unlock heavy door with key
You unlock the heavy door.

>enter heavy door
(first opening the heavy door)

Experimental Room
An intimidatingly large chair sits in the center of the room. The walls are adorned with pictures of words and drawings. Up ahead is an entryway...its door almost completely shattered.

Nearby a heavy door leads west to the Lab.

One drawing is not of an object or person.

You realize the quiet breathing from before is from a man sitting in the chair. He does not look at you and wears a blank expression.

>examine drawing
You examine a drawing of a map. It looks to be a map of where you are. Tally marks are drawn under the map in pencil, along with the words "Sebastian Weaver". "That's the map of this facility," the Voice explains. "As you can see, it's not very big. It's rather obscure. Which is what they wanted." You wonder who Sebastian Weaver is.

* * *

>go north
Maze Room
Giant white walls. It's almost like a human-sized maze. Some blood disturbs the white.

Large holes are on the walls.

Graffiti lines the walls. It looks as if different people had written haphazardly on them.

"It's funny," the Voice muses. "They had to do this damn maze all the time and always complained that they wanted to just get out...it took them a while to figure out that they could just break down the walls. They always had the chance to escape."

>examine graffiti
Much of the graffiti are angry messages: "WE'RE NOT RATS" 
 "YOU MAY MAKE ME FORGET MYSELF, BUT I WON'T FORGET YOUR FACES"

Sylvester walks through the maze with ease and carelessly steps over a tattered folder on the ground.

* * *

>take folder
Taken.

>read folder
It contains a bunch of important looking papers. One in particular stands out: 
 
 Subject 11519 has been exhibiting the same kind of behavior ever since his treatment. He has been traversing the entire facility, each and every room. Whenever he reaches the Experimental room, he marks the map with a tally mark and his initials.
 
 The subject had entered the facility as a young man who suffered from severe depression. He came after we advertised under the new motto that the military had told us to take on: "New memory therapy for your mental health." His consent form reveals that his motive for joining our project was to "Be happier." Memory loss can assist this, but we did not reveal to him the grave turnabout of our experiments, the fact that our research was meant to completely annihilate the capability to remember at all.
 
 But Subject 11519 persists in his travels. He has indeed exhibited memory deterioration, mostly in the form of amnesiac episodes, but he still walks through the facility, makes his marks, and returns to his cell. He does not want to forget. His supervising experimenter, Dr. John Parr, is interested in his antics and insists that we do not interfere. It's worth noting that he has been acting oddly recently; he does not seem enthusiastic and prefers to keep to himself. If 11519"s behavior begins to pester our research, then we will act accordingly. But for the moment, we will let him be.
 
 Note: Humorously enough, he has a travel partner. The damn cat that always manages to escape before we can do anything to him. Perhaps they are both attempting to rebel against us?

"You've been doing well," the Voice suddenly spoke. It sounds quieter than usual. "There is a room up ahead at the end of the maze. Once you're done exploring this area, can you walk through the holes and get to the end of the maze?"

>walk through holes
That's not something you can enter.

>walk through hole
You can't see any such thing.

* * *

>go west
Red Area
Dozens of photos of men and women alike hang on a wire in the air. To the north you can see an entrance to a brightly lit room.

There is a photo within reach.

Sylvester scampers into the room and looks at you meaningfully. "He seems to take a liking to you," the Voice remarks.

>go north
Lab
The room is huge and brightly lit. If you stay quiet, you can hear muffled breathing coming from somewhere...

Nearby a heavy door leads east.

A series of cages line the walls, all open.

There is a small, hand-crafted, wooden maze on a table.

A black cabinet stands near the table.

A cockroach sits placidly on the cabinet surface.

Sylvester hisses and begins to sniff eagerly at the cages.

>examine cabinet
You see nothing special about the cabinet.

>open cabinet
A key is inside! "Well done," the Voice praises. "You should be able to go on your way."

>unlock heavy door
You unlock the heavy door.

>enter heavy door
(first opening the heavy door)

Experimental Room
An intimidatingly large chair sits in the center of the room. The walls are adorned with pictures of words and drawings. 
 
Northward is an entryway...its door hangs off its hinges, almost completely shattered.

Nearby a heavy door leads west to the Lab.

One drawing is not of an object or person.

You realize the quiet breathing from before is from a man sitting in the chair. He does not look at you and wears a blank expression.

>go north
Maze Room
Giant white walls. It's almost like a human-sized maze. Some blood disturbs the white.

Large holes are on the walls.

Graffiti lines the walls. It looks as if different people had written haphazardly on them.

"It's funny," the Voice muses. "They had to do this damn maze all the time and always complained that they wanted to just get out...it took them a while to figure out that they could just break down the walls. They always had the chance to escape."

>squeeze through holes
A large glass-pane window is on the wall beside a door that is blocked by numerous pieces of furniture, from desk parts, table parts, even comfy chairs. "Ah. Well. Time to think of a solution," the Voice says. "Impress me."

>examine furniture
A giant pile of furniture blocks the door.

Table legs stick out of the pile like spikes.

>take table leg
Hmm. Could be useful somehow.

>smash window with table leg
You hit the window with the table leg. The window splinters and breaks, giving you a sizable hole to the next room! "Well done," the Voice praises.

Research Room
A large room half-lit with flickering fluorescent lights. There are photos of men and women on the walls. A map of the human brain is also hung up.

A drawer compartment sits on the floor.

A diary sits on top of a cracked table. "Give it a read." The Voice sounded pained.

[Your score has just gone up by five points.]

>read diary
 
 
Date: September 16, 2014 
We knew it wouldn't take long for them to sniff out what we were doing. But we didn't think they would come so soon. The military wasted no time approaching the supervisor and compelling him (yes, I say compel) to make our facility's research an undercover study. 
We originally strove to find a way to enhance human memory. We failed and found a way to disintegrate it. Our trash became someone else's treasure. 
Those government dogs told us why we should continue. The memory-disintegration method, they claim, will be extraordinarily helpful for their work. POWs will forget all they have seen during their stay with the enemy when they are returned. Those who have seen too much of what lies behind the government veil will no longer be a threat. 
A good number of us have protested vigorously, but not for long, unsurprisingly. Some are thrilled by the change in objective, taking delight in the so-called "partnership" with the military. As for me, I have only the deepest of doubts about this operation. We are doing a service to our country, they said. I feel no pride in doing it. 
In the next month, we are changing the experimentation designs. To find test subjects, we are projecting ourselves to the public under a new slogan that we offer therapeutic treatment for those with mental conditions." 
 
 Entry # 2 
Date: February 6, 2016 
I am supervising the progress of one of the newest participants to arrive to our facility. His name is Sebastian Weaver, under subject number 11519. A typical severely-depressed young male who yearned to be happy. "Do good, Parr," Kevin had said, patting me on the back. I nearly punched his face. 
When I spoke to him during his interview, I wished I had just told him the truth. Just blurt out what we were really doing. But, coward that I am, I didn't. I sometimes wonder why I stay in this damn place, but it is then that I see the faces of Isabel and Joanne. Surely, since I know the truth behind our research, I know a valuable secret of the military. Surely, if I attempt to escape, they will..."deal" with me. And perhaps Isabel and Joanne as well, once they start questioning my disappearance. 
What irony...to believe that the very place I had considered my intellectual monastery is now the darkest of cells. All of us, test subjects and experimenters alike, are like the test rats in the cages of our facility. We are trapped." 
 
The rest of the pages are torn.

"Those were memories. Don't let the apparent absence of memories convince you that they are completely gone. You must explore." The Voice halters. "Someone taught me that. It only took me a while to realize." 
Sylvester sits musingly near the drawer compartment on the ground.

>examine drawer compartment
In the drawer compartment are pencils, pens, a stapler and torn papers.

>read torn papers
 
 Entry #5 
 Date: October 6, 2016 
 Subject 11519...no, Sebastian...has been walking around the facility every day for the past two months. I followed him and saw what he was doing. He was marking his travels. At that moment, I gained clarity. He was attempting to retain his memories. 
 I became excited. I told Sebastian to mark his initials as well, instead of just making tally marks. I even let the cat follow him nearly all the times he walked, just as another supplement to his memory retention, a constant in his daily activity. He is the first to exhibit such behavior. And it is subtle enough that no one else would suspect him, of both of us, doing anything.

You see a tape recorder under the papers.

>listen to tape recorder
A voice speaks. It is masculine and sounds bone-weary. The voice sounds somewhat familiar. 
"So they've finally rebelled. At long last. Luckily for me, I expected it. I heard the subjects murmur under their breaths, fall silent when an experimenter walks by. But I heard them. They knew. They figured it out 
They've done a fine job. Made every one of my colleagues run faster than I've ever seen them run. I hid in this room until the storm passed. When I ventured outside, the facility was empty. The test subjects escaped...well, most of them. There is still Subject 46, Edward Baker, and, of course...he must still be around." 
There is a hefty sigh. 
 "It's been two days since the breakout. The military hasn't arrived. If they do, they'll just find me, and two failures of test subjects. Hah. Well, my dear, dear government, how do you like that?" 
You hear the sound of a bottle swishing. The man recording must be drinking something. 
"Regardless...I'm glad. I'm not quite sure what I should do now. I considered burning this place down. Maybe I should. Make it seem like this place never existed...wipe it out of people's memories...heh! After that, I'll go home...yes, I'll go home. And make myself disappear. They can't find me. Nor my family. 
And yet...I linger here. Perhaps I've grown attached to my haven-turned-prison. A bittersweet attachment. No matter. I've stayed here for long enough. I must depart before those uniform-donning dogs arrive. 
Ah...but of course... Yes. My sliver of hope throughout all these months. The resistor. I feel the urge to watch him again...to observe his steady march through the facility...He forgets every time he does it, but he does it every day...like an automaton. 
I think...I will stay. Watch him, for one last time, before I leave this place. But this time, he won't return to his cell. He'll be gone, like the others. I'll make sure of it. 
My name is Doctor John Parr, supervising researcher at Soma Memory Labs. Date...I've lost track. Who cares. This will be my last experimental observation." 
 
 The recorder falls silent. 
 "...Yes. That's it." The Voice sounds faintly approving. "Well done. Do you see that keypad to your right? Why don't you type in the key. You're almost done."

>examine keypad
There are numbers on the keypad.

"Who are you?" the Voice asks. "What is the key?":

>type 11519
The keypad clicks and beeps. Suddenly, the wall slides back, revealing an entrance.

Exit
A dark room. The right wall is covered with numerous televisions, each depicting a room you have explored. 
A door is up ahead. Above it is a sign with neon-red letters: EXIT.

You can see a doctor here.

>examine doctor
A middle-aged. He is wearing a white gown that has been dirtied. His face is haggard and his eyes droop by the weight of their bags. One lens of his glasses is cracked. He nods once and speaks. 
"You've made it. This is the 93rd time you've walked the halls of this facility, but you never ended up here. Yes, you've been experiencing amnesiac episodes, but those will pass soon enough. I've stopped treating you months ago, so you won't end up like...like Subject 14." 
His voice, although weary, sounds like the Voice. His breath reeks of alcohol. 
"Many dreams were built here. Many...memories." He grounds out the word. "It won't be long before they find us. Find me. I've stayed here for too long. And I must go." 
He cracks a small smile at you. An artificial smile. "My name is Doctor John Parr," he says in the voice of a doctor greeting a patient. The words sound familiar. As if you had heard it months ago. "Your experiment has been concluded. Thank you for your participation. We value your support and patience. But tell me..." He stops, swallows, and suddenly looks pleading. "Can...can you forgive us? For what we've done?"

>forgive doctor
The doctor opens the door, revealing a flat, sandy field. Outside. "Forget I existed," he says quietly. "Forget this face. Live your life and make lasting memories. I hope you become happy, Sebastian Weaver. Goodbye." 
 
You step outside and feel the sand under your shoes. The wind blows gently. The sun's bright and you have to squint to adjust to the glare. 
Beside you, Sylvester meows and purrs against your leg. 
Slowly, you make your way down the field, Sylvester by your side, beginning a long, long walk."

    *** You have won ***

In that game you scored 5 out of a possible 0, in 22 turns.

Would you like to RESTART, RESTORE a saved game, QUIT or UNDO the last command?

* * *

>touch Sylvester
Sylvester seems relaxed and complacent. His collar is right under your hand. Maybe you can take a closer look at it.

>examine collar
It has the letters "--MORY LABS." Some letters are blurred out. The initials "S.W." are scrawled on it.

[Your score has just gone up by five points.]

>go west
Red Room
Dozens of photos of men and women alike, from young to old, hang on a wire in the air. This is a photo-developing room, it seems. To the north you can see an entrance to a brightly lit room.

There is a photo within reach, dangling precariously from a clip on the wire.

Out of the corner of your eye, you see a white mouse nibbling at something near the wall.

>examine mouse
It has something in its paws...your feline friend hasn't noticed it yet.

>point at mouse
That's not a verb I recognise.

>pointing at mouse
You nudge Sylvester with your foot, earning a growl as he looks over his shoulder at you. You quickly stab a finger at the mouse, and Sylvester's eyes widen and he immediately goes into a crouch, stalking rapidly towards the mouse. You turn away, and after a few seconds, see Sylvester silently walk away. The mouse is gone. What seems to be a brochure is on the ground where it was...

[Your score has just gone up by five points.]

>read brochure
It's been bitten through badly, but on the cover you can make out a picture of a nice-looking, white building. Inside, you can read some of the words: "new technology--breakthr--gh treatment--mem--."

>go north
Lab
The room is huge and brightly lit. It smells like a zoo. If you stay quiet, you can hear muffled breathing coming from somewhere...

A heavy door leadseast.

A series of cages line the walls, all open.

There is a small, hand-crafted, wooden maze on a table.

A black cabinet stands near the table.

A cockroach sits placidly on the cabinet surface.

Sylvester saunters into the room after you, purring and wearing a rather satisfied look on his face. You can only guess why.

>examine cages
Looking into some cages, you see tufts of different fur inside. Were they from different animals?

[Your score has just gone up by three points.]

>open cabinet
The cockroach seems to be staring straight into your soul, and you get the worst goosebumps. "Defeated by an insect?" the Voice speaks with a tinge of amusement. "I won't judge you."

>kill cockroach
You smash the cockroach with your foot.

[Your score has just gone up by three points.]

>open cabinet
That's not something you can open.

* * *

>flip clipboard over
You turn the clipboard over and see a message carved into the wooden surface: 
"Wrong. Wrong. All wrongwrongwrong."

[Your score has just gone up by three points.]

>turn on safelight
You can't see any such thing.

>go east
Chamber
A brightly lit room that is white as snow. A large TV sits in the corner, along with a few chairs. Some coffee tables sit nearby. A small camera hangs nearly thirteen feet above you. The floor is spotless.

The camera beeps to life. It swivels and points down to you. You see the lens readjusting, focusing.

>go west
Equipment Area
The room is entirely trashed. Papers are scattered all over the gray floor. Westward you can see another room, lit in an ominous red color.

You see some photos that resemble X-rays, but they appear to be burnt.

A deplorable desk is here.

A bedraggled white cat sits snugly on top of a messy desk. A collar is around its neck. It stares at you with beady yellow eyes. 
"That's Sylvester." You jump, startled, as you hear the artificial Voice echo in the room you're in. "He's quite a friendly cat. He enjoys a nice touch on the head."

On the ground there is a fallen clipboard with some ripped pages.

* * *

>go north
Chamber
A brightly lit room that is white as snow. A large TV sits in the corner, along with a few chairs. Some coffee tables sit nearby. A small camera hangs nearly thirteen feet above you. The floor is spotless.

The camera beeps to life. It swivels and points down to you. You see the lens readjusting, focusing.

Suddenly, the room echoes with the sound of a tinny voice. It sounds somewhat muffled, hidden behind an artificial tone. "Hello. You finally woke up, I see. Hope you had adequate sleep. Can you give me a greeting so I know that you can hear me?"

>go left
Equipment Area
The room is entirely trashed. Papers are scattered all over the gray floor. Westward you can see another room, lit in an ominous red color.

You see some photos that resemble X-rays, but they appear to be burnt.

A deplorable desk is here.

A bedraggled white cat sits snugly on top of a messy desk. A collar is around its neck. It stares at you with beady yellow eyes. 
"That's Sylvester." You jump, startled, as you hear the artificial Voice echo in the room you're in. "He's quite a friendly cat. He enjoys a nice touch on the head."

>go west
Red Room
Dozens of photos of men and women alike, from young to old, hang on a wire in the air. This is a photo-developing room, it seems. To the north you can see an entrance to a brightly lit room.

There is a photo within reach, dangling precariously from a clip on the wire.

Out of the corner of your eye, you see a white mouse nibbling at something near the wall.

>go north
Lab
The room is huge and brightly lit. It smells like a zoo. If you stay quiet, you can hear muffled breathing coming from somewhere...

A heavy door leads east.

A series of cages line the walls, all open.

There is a small, hand-crafted, wooden maze on a table.

A black cabinet stands near the table.

A cockroach sits placidly on the cabinet surface.

Sylvester saunters into the room after you, purring and wearing a rather satisfied look on his face. You can only guess why.

>open cabinet
A key is inside! "Well done," the Voice praises. "You should be able to go on your way."

>take key
You already have that.

>unlock heavy door with key
You unlock the heavy door.

* * *

>enter heavy door
(first opening the heavy door)

Experimental Room
An intimidatingly large chair sits in the center of the room. The walls are adorned with pictures of words and drawings. Up ahead is an entryway...its door almost completely shattered.

Nearby a heavy door leads west to the Lab.

One drawing is not of an object or person.

You realize the quiet breathing from before is from a man sitting in the chair. He does not look at you and wears a blank expression.

>go north
Maze Room
Giant white walls. It's almost like a human-sized maze. Some blood disturbs the white.

Large holes are on the walls.

Graffiti lines the walls. It looks as if different people had written haphazardly on them.

"It's funny," the Voice muses. "They had to do this damn maze all the time and always complained that they wanted to just get out...it took them a while to figure out that they could just break down the walls. They always had the chance to escape."

* * *

>examine graffiti
Much of the graffiti are angry messages: "WE'RE NOT RATS" 
 "YOU MAY MAKE ME FORGET MYSELF, BUT I WON'T FORGET YOUR FACES"

Sylvester walks through the maze with ease and carelessly steps over a tattered folder on the ground.

>examine folder
It contains a bunch of important looking papers. One in particular stands out: 
 
 Subject 11519 has been exhibiting the same kind of behavior ever since his treatment. He has been traversing the entire facility, each and every room. Whenever he reaches the Experimental room, he marks the map with a tally mark and his initials.
 
 The subject had entered the facility as a young man who suffered from severe depression. He came after we advertised under the new motto that the military had told us to take on: "New memory therapy for your mental health." His consent form reveals that his motive for joining our project was to "Be happier." Memory loss can assist this, but we did not reveal to him the grave turnabout of our experiments, the fact that our research was meant to completely annihilate the capability to remember at all.
 
 But Subject 11519 persists in his travels. He has indeed exhibited memory deterioration, mostly in the form of amnesiac episodes, but he still walks through the facility, makes his marks, and returns to his cell. He does not want to forget. His supervising experimenter, Dr. John Parr, is interested in his antics and insists that we do not interfere. It's worth noting that he has been acting oddly recently; he does not seem enthusiastic and prefers to keep to himself. If 11519"s behavior begins to pester our research, then we will act accordingly. But for the moment, we will let him be.
 
 Note: Humorously enough, he has a travel partner. The damn cat that always manages to escape before we can do anything to him. Perhaps they are both attempting to rebel against us?

"You've been doing well," the Voice suddenly spoke. It sounds quieter than usual. "There is a room up ahead at the end of the maze. Once you're done exploring this area, can you squeeze through the holes and get to the end of the maze?"

>squeeze through holes
A large glass-pane window is on the wall beside a door that is blocked by numerous pieces of furniture, from desk parts, table parts, even comfy chairs. "Ah. Well. Time to think of a solution," the Voice says. "Impress me."

>examine window
It's made of glass. Hmm...

>examine furniture
A giant pile of furniture blocks the door.

Table legs stick out of the pile like spikes.

* * *

>take table leg
Hmm. Could be useful somehow.

>smash window with table leg
You can't see any such thing.

>smash window
Violence isn't the answer to this one.

* * *

>open cabinet
A key is inside! "Well done," the Voice praises. "You should be able to go on your way."

>take ey
You can't see any such thing.

>take key
You already have that.

* * *

>unlock heavy door with key
You unlock the heavy door.

>unlock heavy door
The heavy door is already unlocked.

>enter heavy door
(first opening the heavy door)

Experimental Room
An intimidatingly large chair sits in the center of the room. The walls are adorned with pictures of words and drawings. Up ahead is an entryway...its door almost completely shattered.

Nearby a heavy door leads west to the Lab.

One drawing is not of an object or person.

You realize the quiet breathing from before is from a man sitting in the chair. He does not look at you and wears a blank expression.

* * *

>take table leg
Hmm. Could be useful somehow.

>smash window
Violence isn't the answer to this one.

>smash window with table lg
You can't see any such thing.

>smash window with table leg
You can't see any such thing.

* * *

>examine graffiti
Much of the graffiti are angry messages: "WE'RE NOT RATS" 
 "YOU MAY MAKE ME FORGET MYSELF, BUT I WON'T FORGET YOUR FACES"

Sylvester walks through the maze with ease and carelessly steps over a tattered folder on the ground.

>examine flder
You can't see any such thing.

>examine folder
It contains a bunch of important looking papers. One in particular stands out: 
 
 Subject 11519 has been exhibiting the same kind of behavior ever since his treatment. He has been traversing the entire facility, each and every room. Whenever he reaches the Experimental room, he marks the map with a tally mark and his initials.
 
 The subject had entered the facility as a young man who suffered from severe depression. He came after we advertised under the new motto that the military had told us to take on: "New memory therapy for your mental health." His consent form reveals that his motive for joining our project was to "Be happier." Memory loss can assist this, but we did not reveal to him the grave turnabout of our experiments, the fact that our research was meant to completely annihilate the capability to remember at all.
 
 But Subject 11519 persists in his travels. He has indeed exhibited memory deterioration, mostly in the form of amnesiac episodes, but he still walks through the facility, makes his marks, and returns to his cell. He does not want to forget. His supervising experimenter, Dr. John Parr, is interested in his antics and insists that we do not interfere. It's worth noting that he has been acting oddly recently; he does not seem enthusiastic and prefers to keep to himself. If 11519"s behavior begins to pester our research, then we will act accordingly. But for the moment, we will let him be.
 
 Note: Humorously enough, he has a travel partner. The damn cat that always manages to escape before we can do anything to him. Perhaps they are both attempting to rebel against us?

"You've been doing well," the Voice suddenly spoke. It sounds quieter than usual. "There is a room up ahead at the end of the maze. Once you're done exploring this area, can you squeeze through the holes and get to the end of the maze?"

* * *

>smash window
Violence isn't the answer to this one.

>smash window with table leg
You hit the window with the table leg. The window splinters and breaks, giving you a sizable hole to the next room! "Well done," the Voice praises.

Research Room
A large room half-lit with flickering fluorescent lights. There are photos of men and women on the walls. A map of the human brain.

A drawer compartment sits on the floor.

A diary sits on top of a cracked table. "Give it a read." The Voice sounded pained.

>read diary
 
 Date: September 16, 2014 
We knew it wouldn't take long for them to sniff out what we were doing. But we didn't think they would come so soon. The military wasted no time approaching the supervisor and compelling him (yes, I say compel) to make our facility's research an undercover study. 
 We originally strove to find a way to enhance human memory. We failed and found a way to disintegrate it. Our trash became someone else's treasure. 
 Those government dogs told us why we should continue.  disintegration method, they claim, will be extraordinarily helpful for their work. POWs will forget all they have seen during their stay with the enemy when they are returned. Those who have seen too much of what lies behind the government veil will no longer be a threat. 
 A good number of us have protested vigorously, but not for long, unsurprisingly. Some are thrilled by the change in objective, taking delight in the so-called "partnership" with the military. As for me, I have only the deepest of doubts about this operation. We are doing a service to our country, they said. I feel no pride for doing it. 
 In the next month, we are changing the experimentation designs. To find test subjects, we are projecting ourselves to the public under a new slogan that we offer therapeutic treatment for those with mental conditions." 
 
 "Entry # 2 
Date: February 6, 2016 
 I am supervising the progress of one of the newest participants to arrive to our facility. His name is Sebastian Weaver, under subject number 11519. A typical severely-depressed young male who yearned to be happy. "Do good, Parr," Kevin had said, patting me on the back. I almost wanted to punch his face. 
 When I spoke to him during his interview, I wished I had just told him the truth. Just blurt out what we were really doing. But, coward that I am, I didn't. I sometimes wonder why I stayed in this damn place, but it is then that I see the face of Isabel and Joanne. Surely, since I know the truth behind our research, I know a valuable secret of the military. Surely, if I attempt to escape, they will..."deal" with me. And perhaps Isabel and Joanne as well, once they start questioning my disappearance. 
 What irony...to believe that the very place I had considered my intellectual monastery is now my the darkest of cells. All of us, test subjects and experimenters alike, are like the rats in the cages of our facility." 
 The rest of the pages are torn.

>read diary
 
 Date: September 16, 2014 
We knew it wouldn't take long for them to sniff out what we were doing. But we didn't think they would come so soon. The military wasted no time approaching the supervisor and compelling him (yes, I say compel) to make our facility's research an undercover study. 
 We originally strove to find a way to enhance human memory. We failed and found a way to disintegrate it. Our trash became someone else's treasure. 
 Those government dogs told us why we should continue.  disintegration method, they claim, will be extraordinarily helpful for their work. POWs will forget all they have seen during their stay with the enemy when they are returned. Those who have seen too much of what lies behind the government veil will no longer be a threat. 
 A good number of us have protested vigorously, but not for long, unsurprisingly. Some are thrilled by the change in objective, taking delight in the so-called "partnership" with the military. As for me, I have only the deepest of doubts about this operation. We are doing a service to our country, they said. I feel no pride for doing it. 
 In the next month, we are changing the experimentation designs. To find test subjects, we are projecting ourselves to the public under a new slogan that we offer therapeutic treatment for those with mental conditions." 
 
 "Entry # 2 
Date: February 6, 2016 
 I am supervising the progress of one of the newest participants to arrive to our facility. His name is Sebastian Weaver, under subject number 11519. A typical severely-depressed young male who yearned to be happy. "Do good, Parr," Kevin had said, patting me on the back. I almost wanted to punch his face. 
 When I spoke to him during his interview, I wished I had just told him the truth. Just blurt out what we were really doing. But, coward that I am, I didn't. I sometimes wonder why I stayed in this damn place, but it is then that I see the face of Isabel and Joanne. Surely, since I know the truth behind our research, I know a valuable secret of the military. Surely, if I attempt to escape, they will..."deal" with me. And perhaps Isabel and Joanne as well, once they start questioning my disappearance. 
 What irony...to believe that the very place I had considered my intellectual monastery is now my the darkest of cells. All of us, test subjects and experimenters alike, are like the rats in the cages of our facility." 
 The rest of the pages are torn.

* * *

>take table leg
Hmm. Could be useful somehow.

>smash window with table leg
You hit the window with the table leg. The window splinters and breaks, giving you a sizable hole to the next room! "Well done," the Voice praises.

Research Room
A large room half-lit with flickering fluorescent lights. There are photos of men and women on the walls. A map of the human brain is also hung up.

A drawer compartment sits on the floor.

A diary sits on top of a cracked table. "Give it a read." The Voice sounded pained.

>read diary
 
 
 Date: September 16, 2014 
We knew it wouldn't take long for them to sniff out what we were doing. But we didn't think they would come so soon. The military wasted no time approaching the supervisor and compelling him (yes, I say compel) to make our facility's research an undercover study. 
 We originally strove to find a way to enhance human memory. We failed and found a way to disintegrate it. Our trash became someone else's treasure. 
 Those government dogs told us why we should continue.  disintegration method, they claim, will be extraordinarily helpful for their work. POWs will forget all they have seen during their stay with the enemy when they are returned. Those who have seen too much of what lies behind the government veil will no longer be a threat. 
 A good number of us have protested vigorously, but not for long, unsurprisingly. Some are thrilled by the change in objective, taking delight in the so-called "partnership" with the military. As for me, I have only the deepest of doubts about this operation. We are doing a service to our country, they said. I feel no pride for doing it. 
 In the next month, we are changing the experimentation designs. To find test subjects, we are projecting ourselves to the public under a new slogan that we offer therapeutic treatment for those with mental conditions." 
 
 "Entry # 2 
Date: February 6, 2016 
 I am supervising the progress of one of the newest participants to arrive to our facility. His name is Sebastian Weaver, under subject number 11519. A typical severely-depressed young male who yearned to be happy. "Do good, Parr," Kevin had said, patting me on the back. I almost wanted to punch his face. 
 When I spoke to him during his interview, I wished I had just told him the truth. Just blurt out what we were really doing. But, coward that I am, I didn't. I sometimes wonder why I stayed in this damn place, but it is then that I see the face of Isabel and Joanne. Surely, since I know the truth behind our research, I know a valuable secret of the military. Surely, if I attempt to escape, they will..."deal" with me. And perhaps Isabel and Joanne as well, once they start questioning my disappearance. 
 What irony...to believe that the very place I had considered my intellectual monastery is now my the darkest of cells. All of us, test subjects and experimenters alike, are like the rats in the cages of our facility." 
 The rest of the pages are torn.

>examine diary
 
 
 Date: September 16, 2014 
We knew it wouldn't take long for them to sniff out what we were doing. But we didn't think they would come so soon. The military wasted no time approaching the supervisor and compelling him (yes, I say compel) to make our facility's research an undercover study. 
 We originally strove to find a way to enhance human memory. We failed and found a way to disintegrate it. Our trash became someone else's treasure. 
 Those government dogs told us why we should continue.  disintegration method, they claim, will be extraordinarily helpful for their work. POWs will forget all they have seen during their stay with the enemy when they are returned. Those who have seen too much of what lies behind the government veil will no longer be a threat. 
 A good number of us have protested vigorously, but not for long, unsurprisingly. Some are thrilled by the change in objective, taking delight in the so-called "partnership" with the military. As for me, I have only the deepest of doubts about this operation. We are doing a service to our country, they said. I feel no pride for doing it. 
 In the next month, we are changing the experimentation designs. To find test subjects, we are projecting ourselves to the public under a new slogan that we offer therapeutic treatment for those with mental conditions." 
 
 "Entry # 2 
Date: February 6, 2016 
 I am supervising the progress of one of the newest participants to arrive to our facility. His name is Sebastian Weaver, under subject number 11519. A typical severely-depressed young male who yearned to be happy. "Do good, Parr," Kevin had said, patting me on the back. I almost wanted to punch his face. 
 When I spoke to him during his interview, I wished I had just told him the truth. Just blurt out what we were really doing. But, coward that I am, I didn't. I sometimes wonder why I stayed in this damn place, but it is then that I see the face of Isabel and Joanne. Surely, since I know the truth behind our research, I know a valuable secret of the military. Surely, if I attempt to escape, they will..."deal" with me. And perhaps Isabel and Joanne as well, once they start questioning my disappearance. 
 What irony...to believe that the very place I had considered my intellectual monastery is now my the darkest of cells. All of us, test subjects and experimenters alike, are like the rats in the cages of our facility." 
 The rest of the pages are torn.

* * *

>go north
Lab
The room is huge and brightly lit. It smells like a zoo. If you stay quiet, you can hear muffled breathing coming from somewhere...

A heavy door leads east.

A series of cages line the walls, all open.

There is a small, hand-crafted, wooden maze on a table.

A black cabinet stands near the table.

A cockroach sits placidly on the cabinet surface.

Sylvester saunters into the room after you, purring and wearing a rather satisfied look on his face. You can only guess why.

>examine heavy door
It's locked shut and is quite heavy. "Brilliant scientists, but dumb as an acorn. They say most fools don't keep a key more than 20 feet away from where the door is," the Voice speaks, somewhat dryly.

>open heavy door
It seems to be locked.

>open cabinet
The cockroach seems to be staring straight into your soul, and you get the worst goosebumps. "Defeated by an insect?" the Voice speaks with a tinge of amusement. "I won't judge you."

>go south
Red Room
Dozens of photos of men and women alike, from young to old, hang on a wire in the air. This is a photo-developing room, it seems. To the north you can see an entrance to a brightly lit room.

There is a photo within reach, dangling precariously from a clip on the wire.

Out of the corner of your eye, you see a white mouse nibbling at something near the wall.

>point at mouse
You nudge Sylvester with your foot, earning a growl as he looks over his shoulder at you. You quickly stab a finger at the mouse, and Sylvester's eyes widen and he immediately goes into a crouch, stalking rapidly towards the mouse. You turn away, and after a few seconds, see Sylvester silently walk away. The mouse is gone. What seems to be a brochure is on the ground where it was...

[Your score has just gone up by five points.]

>go north
Lab
The room is huge and brightly lit. It smells like a zoo. If you stay quiet, you can hear muffled breathing coming from somewhere...

A heavy door leads east.

A series of cages line the walls, all open.

There is a small, hand-crafted, wooden maze on a table.

A black cabinet stands near the table.

A cockroach sits placidly on the cabinet surface.

* * *

>go north
Chamber
A brightly lit room that is white as snow. A large TV sits in the corner, along with a few chairs. Some coffee tables sit nearby. A small camera hangs nearly thirteen feet above you. The floor is spotless.

The camera beeps to life. It swivels and points down to you. You see the lens readjusting, focusing.

Suddenly, the room echoes with the sound of a tinny voice. It sounds somewhat muffled, hidden behind an artificial tone. "Hello. You finally woke up, I see. Hope you had adequate sleep. Can you give me a greeting so I know that you can hear me?"

>go west
Equipment Area
The room is entirely trashed. Papers are scattered all over the gray floor. Westward you can see another room, lit in an ominous red color.

You see some photos that resemble X-rays, but they appear to be burnt.

A deplorable desk is here.

A bedraggled white cat sits atop the desk.

On the ground there is a fallen clipboard with some ripped pages.

The cat stares at you with beady yellow eyes. 
"That's Sylvester." You jump, startled, as you hear the artificial Voice echo in the room you're in. "He's quite a friendly cat. He enjoys a nice touch on the head."

>go west
Red Room
Dozens of photos of men and women alike, from young to old, hang on a wire in the air. This is a photo-developing room, it seems. To the north you can see an entrance to a brightly lit room.

There is a photo within reach, dangling precariously from a clip on the wire.

Hanging on the wall is a safelight.

Out of the corner of your eye, you see a white mouse nibbling at something near the wall.

Sylvester scampers into the room and looks at you meaningfully. "He seems to take a liking to you," the Voice remarks. Sylvester turns and faces the entrance you just came from, grooming himself.

>go north
Lab
The room is huge and brightly lit. It smells like a zoo. If you stay quiet, you can hear muffled breathing coming from somewhere...

A heavy door leads east.

A series of cages line the walls, all open.

There is a small, hand-crafted, wooden maze on a table.

A black cabinet stands near the table.

A disgusting brown cockroach sits on top of the cabinet.

Sylvester saunters into the room after you, purring and wearing a rather satisfied look on his face. You can only guess why.

>examine cabinet
You see nothing special about the cabinet.

>examine cockroach
Ew. You'd rather not touch the cabinet with that thing running around. "Didn't think THAT would stop you," the Voice remarks.

>open cabinet
A key is inside! "Well done," the Voice praises. "You should be able to go on your way."

* * *

>examine cockroach
Ew. You'd rather not touch the cabinet with that thing running around. "Didn't think THAT would stop you," the Voice remarks.

>kill cockroach
You smash the cockroach with your foot.

[Your score has just gone up by three points.]

>open cabinet
A key is inside! "Well done," the Voice praises. "You should be able to go on your way."

* * *

>unlock heavy door
You unlock the heavy door.

>enter heavy door
(first opening the heavy door)

Experimental Room
An intimidatingly large chair sits in the center of the room. The walls are adorned with pictures of words and drawings. Up ahead is an entryway...its door almost completely shattered.

Nearby a heavy door leads west to the Lab.

One drawing is not of an object or person.

You realize the quiet breathing from before is from a man sitting in the chair. He does not look at you and wears a blank expression.

* * *

>smash window
Violence isn't the answer to this one.

>smash window with table leg
You hit the window with the table leg. The window splinters and breaks, giving you a sizable hole to the next room! "Well done," the Voice praises.

Research Room
A large room half-lit with flickering fluorescent lights. There are photos of men and women on the walls. A map of the human brain is also hung up.

A drawer compartment sits on the floor.

A diary sits on top of a cracked table. "Give it a read." The Voice sounded pained.

>read diary
 
 
 Date: September 16, 2014 
We knew it wouldn't take long for them to sniff out what we were doing. But we didn't think they would come so soon. The military wasted no time approaching the supervisor and compelling him (yes, I say compel) to make our facility's research an undercover study. 
 We originally strove to find a way to enhance human memory. We failed and found a way to disintegrate it. Our trash became someone else's treasure. 
 Those government dogs told us why we should continue.  disintegration method, they claim, will be extraordinarily helpful for their work. POWs will forget all they have seen during their stay with the enemy when they are returned. Those who have seen too much of what lies behind the government veil will no longer be a threat. 
 A good number of us have protested vigorously, but not for long, unsurprisingly. Some are thrilled by the change in objective, taking delight in the so-called "partnership" with the military. As for me, I have only the deepest of doubts about this operation. We are doing a service to our country, they said. I feel no pride for doing it. 
 In the next month, we are changing the experimentation designs. To find test subjects, we are projecting ourselves to the public under a new slogan that we offer therapeutic treatment for those with mental conditions." 
 
 "Entry # 2 
Date: February 6, 2016 
 I am supervising the progress of one of the newest participants to arrive to our facility. His name is Sebastian Weaver, under subject number 11519. A typical severely-depressed young male who yearned to be happy. "Do good, Parr," Kevin had said, patting me on the back. I almost wanted to punch his face. 
 When I spoke to him during his interview, I wished I had just told him the truth. Just blurt out what we were really doing. But, coward that I am, I didn't. I sometimes wonder why I stayed in this damn place, but it is then that I see the face of Isabel and Joanne. Surely, since I know the truth behind our research, I know a valuable secret of the military. Surely, if I attempt to escape, they will..."deal" with me. And perhaps Isabel and Joanne as well, once they start questioning my disappearance. 
 What irony...to believe that the very place I had considered my intellectual monastery is now my the darkest of cells. All of us, test subjects and experimenters alike, are like the rats in the cages of our facility." 
 
The rest of the pages are torn.

"Those were memories. Don't let the apparent absence of memories convince you that they are completely gone. You must explore." The Voice halters. "Someone taught me that. It only took me a while to realize." 
 Sylvester sits musingly near the drawer compartment on the ground.

>examine drawer compartment
In the drawer compartment are pencils, pens, a stapler and torn papers.

* * *

>listen to tape recorder
A voice speaks. It is masculine and sounds bone-weary. The voice sounds somewhat familiar. 
 "So they've finally rebelled. At long last. Luckily for me, I expected it. I heard the subjects murmur under their breaths, fall silent when an experimenter walks by. But I heard them. They knew. They figured it out 
 They've done a fine job. Made every one of my colleagues run faster than I've ever seen them run. I hid in this room until the storm passed. When I ventured outside, the facility was empty. The test subjects escaped...well, most of them. There is still Subject 46, Edward Baker, and, of course...he must still be around." 
 There is a hefty sigh. 
 "It's been two days since the breakout. The military hasn't arrived. If they do, they'll just find me, and two failures of test subjects. Hah. Well, my dear, dear government, how do you like that?" 
 You hear the sound of a bottle swishing. The man recording must be drinking something. 
 "Regardless...I'm glad. I'm not quite sure what I should do now. I considered burning this place down. Maybe I should. Make it seem like this place never existed...wipe it out of people's memories...heh! After that, I'll go home...yes, I'll go home. And make myself disappear. They can't find me. Nor my family. 
 And yet...I linger here. Perhaps I've grown attached to my haven-turned-prison. A bittersweet attachment. No matter. I've stayed here for long enough. I must depart before those uniform-donning dogs arrive. 
 Ah...but of course... Yes. My sliver of hope throughout all these months. The resistor. I feel the urge to watch him again...to observe his steady march through the facility...He forgets every time he does it, but he does it every day...like an automaton. 
I think...I will stay. Watch him, for one last time, before I leave this place. But this time, he won't return to his cell. He'll be gone, like the others. I'll make sure of it. 
 My name is Doctor John Parr, supervising researcher at Soma Memory Labs. Date...I've lost track. Who cares. This will be my last experimental observation." 
 
 The recorder falls silent. 
 "...Yes. That's it." The Voice sounds faintly approving. "Well done. Do you see that keypad to your right? Why don't you type in the key. You're almost done."

>examine keypad
You can't see any such thing.

* * *

>go north
Lab
The room is huge and brightly lit. It smells like a zoo. If you stay quiet, you can hear muffled breathing coming from somewhere...

A heavy door leads east.

A series of cages line the walls, all open.

There is a small, hand-crafted, wooden maze on a table.

A black cabinet stands near the table.

A disgusting brown cockroach sits on top of the cabinet.

Sylvester saunters into the room after you, purring and wearing a rather satisfied look on his face. You can only guess why.

>open cabinet
A key is inside! "Well done," the Voice praises. "You should be able to go on your way."

* * *

>take key
You already have that.

>unlock heavy door
You unlock the heavy door.

* * *

>examine drawer compartment
In the drawer compartment are pencils, pens, a stapler and torn papers.

>examine torn papers
 
 Entry #5 
 Date: October 6, 2016 
 11519...no, Sebastian...has been walking around the facility every day for the past two months. I followed him and saw what he was doing. He was marking his travels. At that moment, I gained clarity. He was attempting to retain his memories. 
 I became excited. I told Sebastian to mark his initials as well, instead of just making tally marks. I even let the cat follow him nearly all the times he walked as another supplement to his memory retention, a constant in his daily life. He is the first to exhibit such behavior. And it is subtle enough that no one else would suspect him, of both of us, doing anything.

You see a tape recorder under the papers.

>listen to tape recorder
You can't see any such thing.

* * *

>open cabinet
A key is inside! "Well done," the Voice praises. "You should be able to go on your way."

>unlock heavy door with key
You unlock the heavy door.

>go through
(the key)
That's not something you can enter.

>enter heavy door
(first opening the heavy door)

Experimental Room
An intimidatingly large chair sits in the center of the room. The walls are adorned with pictures of words and drawings. 
Up ahead is an entryway...its door hangs off its hinges, almost completely shattered.

Nearby a heavy door leads west to the Lab.

One drawing is not of an object or person.

You realize the quiet breathing from before is from a man sitting in the chair. He does not look at you and wears a blank expression.

>go north
Maze Room
Giant white walls. It's almost like a human-sized maze. Some blood disturbs the white.

Large holes are on the walls.

Graffiti lines the walls. It looks as if different people had written haphazardly on them.

"It's funny," the Voice muses. "They had to do this damn maze all the time and always complained that they wanted to just get out...it took them a while to figure out that they could just break down the walls. They always had the chance to escape."

* * *

>smash window with table leg
You hit the window with the table leg. The window splinters and breaks, giving you a sizable hole to the next room! "Well done," the Voice praises.

Research Room
A large room half-lit with flickering fluorescent lights. There are photos of men and women on the walls. A map of the human brain is also hung up.

A drawer compartment sits on the floor.

A diary sits on top of a cracked table. "Give it a read." The Voice sounded pained.

>examine drawer compartment
In the drawer compartment are pencils, pens, a stapler and torn papers.

* * *

>examine keypad
There are numbers on the keypad.

"Who are you?" the Voice asks. "What is the key?":

>type 11519
The keypad clicks and beeps. Suddenly, the wall slides back, revealing an entrance.

Exit
A dark room. The right wall is covered with numerous televisions, each depicting a room you have explored.

A door is up ahead. Above it is a sign with neon-red letters: EXIT. A middle-aged man stands near a door. He is wearing a white gown that has been dirtied. His face is haggard and his eyes droop by the weight of their bags. One lens of his glasses is cracked.

You can also see Doctor John Parr here.

"Who are you?" the Voice asks. "What is the key?":

>examine Doctor John Parr
Incorrect. "You know who you are," the Voice says firmly. "Tell me."

* * *

>unlock heavy door with key
You unlock the heavy door.

>enter heavy door
(first opening the heavy door)

Experimental Room
An intimidatingly large chair sits in the center of the room. The walls are adorned with pictures of words and drawings. 
Up ahead is an entryway...its door hangs off its hinges, almost completely shattered.

Nearby a heavy door leads west to the Lab.

One drawing is not of an object or person.

You realize the quiet breathing from before is from a man sitting in the chair. He does not look at you and wears a blank expression.

* * *

>go north
Maze Room
Giant white walls. It's almost like a human-sized maze. Some blood disturbs the white.

Large holes are on the walls.

Graffiti lines the walls. It looks as if different people had written haphazardly on them.

"It's funny," the Voice muses. "They had to do this damn maze all the time and always complained that they wanted to just get out...it took them a while to figure out that they could just break down the walls. They always had the chance to escape."

>squeeze through large holes
You can't see any such thing.

>squeeze through holes
A large glass-pane window is on the wall beside a door that is blocked by numerous pieces of furniture, from desk parts, table parts, even comfy chairs. "Ah. Well. Time to think of a solution," the Voice says. "Impress me."

* * *

>smash window with table leg
You hit the window with the table leg. The window splinters and breaks, giving you a sizable hole to the next room! "Well done," the Voice praises.

Research Room
A large room half-lit with flickering fluorescent lights. There are photos of men and women on the walls. A map of the human brain is also hung up.

A drawer compartment sits on the floor.

A diary sits on top of a cracked table. "Give it a read." The Voice sounded pained.

[Your score has just gone up by five points.]

>examine drawer compartment
In the drawer compartment are pencils, pens, a stapler and torn papers.

* * *

>look at keypad
There are numbers on the keypad.

"Who are you?" the Voice asks. "What is the key?":

>type 11519
The keypad clicks and beeps. Suddenly, the wall slides back, revealing an entrance.

Exit
A dark room. The right wall is covered with numerous televisions, each depicting a room you have explored.

A door is up ahead. Above it is a sign with neon-red letters: EXIT. A middle-aged man stands near a door. He is wearing a white gown that has been dirtied. His face is haggard and his eyes droop by the weight of their bags. One lens of his glasses is cracked. 
He nods once and speaks. "You've made it. This is the 93rd time you've walked the halls of this facility, but you never ended up here. Yes, you've been experiencing amnesiac episodes, but those will pass soon enough. I've stopped treating you months ago, so you won't end up like...like Subject 14." 
His voice, although weary, sounds like the Voice. His breath reeks of alcohol. 
"Many dreams were built here. Many...memories." He grounds out the word. "It won't be long before they find us. Find me. I've stayed here for too long. And I must go." 
He cracks a small smile at you. An artificial smile. "My name is Doctor John Parr," he says in the voice of a doctor greeting a patient. The words sound familiar. As if you had heard it months ago. "Your experiment has been concluded. Thank you for your participation. We value your support and patience." 
The doctor opens the door, revealing a flat, sandy field. Outside. "Forget I existed," he says quietly. "Forget this face. Live your life and make lasting memories. I hope you become happy, Sebastian Weaver. Goodbye."

>go through exit door
(first opening the exit door)

Field
A door is up ahead. Above it is a sign with neon-red letters: EXIT. A middle-aged man stands near a door. He is wearing a white gown that has been dirtied. His face is haggard and his eyes droop by the weight of their bags. One lens of his glasses is cracked. 
He nods once and speaks. "You've made it. This is the 93rd time you've walked the halls of this facility, but you never ended up here. Yes, you've been experiencing amnesiac episodes, but those will pass soon enough. I've stopped treating you months ago, so you won't end up like...like Subject 14." 
His voice, although weary, sounds like the Voice. His breath reeks of alcohol. 
"Many dreams were built here. Many...memories." He grounds out the word. "It won't be long before they find us. Find me. I've stayed here for too long. And I must go." 
He cracks a small smile at you. An artificial smile. "My name is Doctor John Parr," he says in the voice of a doctor greeting a patient. The words sound familiar. As if you had heard it months ago. "Your experiment has been concluded. Thank you for your participation. We value your support and patience." 
The doctor opens the door, revealing a flat, sandy field. Outside. "Forget I existed," he says quietly. "Forget this face. Live your life and make lasting memories. I hope you become happy, Sebastian Weaver. Goodbye."

>enter exit door
Exit
A dark room. The right wall is covered with numerous televisions, each depicting a room you have explored.

A door is up ahead. Above it is a sign with neon-red letters: EXIT. A middle-aged man stands near a door. He is wearing a white gown that has been dirtied. His face is haggard and his eyes droop by the weight of their bags. One lens of his glasses is cracked. 
He nods once and speaks. "You've made it. This is the 93rd time you've walked the halls of this facility, but you never ended up here. Yes, you've been experiencing amnesiac episodes, but those will pass soon enough. I've stopped treating you months ago, so you won't end up like...like Subject 14." 
His voice, although weary, sounds like the Voice. His breath reeks of alcohol. 
"Many dreams were built here. Many...memories." He grounds out the word. "It won't be long before they find us. Find me. I've stayed here for too long. And I must go." 
He cracks a small smile at you. An artificial smile. "My name is Doctor John Parr," he says in the voice of a doctor greeting a patient. The words sound familiar. As if you had heard it months ago. "Your experiment has been concluded. Thank you for your participation. We value your support and patience." 
The doctor opens the door, revealing a flat, sandy field. Outside. "Forget I existed," he says quietly. "Forget this face. Live your life and make lasting memories. I hope you become happy, Sebastian Weaver. Goodbye."

* * *

>unlock heavy door
You unlock the heavy door.

>enter heavy door
(first opening the heavy door)

Experimental Room
An intimidatingly large chair sits in the center of the room. The walls are adorned with pictures of words and drawings. 
Up ahead is an entryway...its door hangs off its hinges, almost completely shattered.

Nearby a heavy door leads west to the Lab.

One drawing is not of an object or person.

You realize the quiet breathing from before is from a man sitting in the chair. He does not look at you and wears a blank expression.

* * *

>examine keypad
There are numbers on the keypad.

"Who are you?" the Voice asks. "What is the key?":

>type 11519
The keypad clicks and beeps. Suddenly, the wall slides back, revealing an entrance.

Exit
A dark room. The right wall is covered with numerous televisions, each depicting a room you have explored.

A door is up ahead. Above it is a sign with neon-red letters: EXIT. A middle-aged man stands near a door. He is wearing a white gown that has been dirtied. His face is haggard and his eyes droop by the weight of their bags. One lens of his glasses is cracked. 
He nods once and speaks. "You've made it. This is the 93rd time you've walked the halls of this facility, but you never ended up here. Yes, you've been experiencing amnesiac episodes, but those will pass soon enough. I've stopped treating you months ago, so you won't end up like...like Subject 14." 
 His voice, although weary, sounds like the Voice. His breath reeks of alcohol. 
 "Many dreams were built here. Many...memories." He grounds out the word. "It won't be long before they find us. Find me. I've stayed here for too long. And I must go." 
 He cracks a small smile at you. An artificial smile. "My name is Doctor John Parr," he says in a voice of a doctor greeting a patient. It sounds familiar. "Your experiment has been concluded. Thank you for your participation. We value your support and patience. But tell me...can you forgive us? Yes or no?"

>say yes
(to yourself)
There is no reply.

>say yes to Doctor John Parr
You can't see any such thing.

* * *

>go north
Lab
The room is huge and brightly lit. It smells like a zoo. If you stay quiet, you can hear muffled breathing coming from somewhere...

A heavy door leads east.

A series of cages line the walls, all open.

There is a small, hand-crafted, wooden maze on a table.

A black cabinet stands near the table.

A disgusting brown cockroach sits on top of the cabinet.

Sylvester saunters into the room after you, purring and wearing a rather satisfied look on his face. You can only guess why.

>open cabinte
You can't see any such thing.

>open cabinet
A key is inside! "Well done," the Voice praises. "You should be able to go on your way."

* * *

>enter
You must supply a noun.

>enter heavy door
(first opening the heavy door)

Experimental Room
An intimidatingly large chair sits in the center of the room. The walls are adorned with pictures of words and drawings. 
Up ahead is an entryway...its door hangs off its hinges, almost completely shattered.

Nearby a heavy door leads west to the Lab.

One drawing is not of an object or person.

You realize the quiet breathing from before is from a man sitting in the chair. He does not look at you and wears a blank expression.

* * *

>go north
Maze Room
Giant white walls. It's almost like a human-sized maze. Some blood disturbs the white.

Large holes are on the walls.

Graffiti lines the walls. It looks as if different people had written haphazardly on them.

"It's funny," the Voice muses. "They had to do this damn maze all the time and always complained that they wanted to just get out...it took them a while to figure out that they could just break down the walls. They always had the chance to escape."

>squeeze through the large holes
You can't see any such thing.

>squeeze through the holes
A large glass-pane window is on the wall beside a door that is blocked by numerous pieces of furniture, from desk parts, table parts, even comfy chairs. "Ah. Well. Time to think of a solution," the Voice says. "Impress me."

>examine furniture
A giant pile of furniture blocks the door.

Table legs stick out of the pile like spikes.

* * *

>smash window with table leg
You hit the window with the table leg. The window splinters and breaks, giving you a sizable hole to the next room! "Well done," the Voice praises.

Research Room
A large room half-lit with flickering fluorescent lights. There are photos of men and women on the walls. A map of the human brain is also hung up.

A drawer compartment sits on the floor.

A diary sits on top of a cracked table. "Give it a read." The Voice sounded pained.

>examine drawer
In the drawer compartment are pencils, pens, a stapler and torn papers.

>read torn papers
 
 Entry #5 
 Date: October 6, 2016 
 Subject 11519...no, Sebastian...has been walking around the facility every day for the past two months. I followed him and saw what he was doing. He was marking his travels. At that moment, I gained clarity. He was attempting to retain his memories. 
 I became excited. I told Sebastian to mark his initials as well, instead of just making tally marks. I even let the cat follow him nearly all the times he walked, just as another supplement to his memory retention, a constant in his daily activity. He is the first to exhibit such behavior. And it is subtle enough that no one else would suspect him, of both of us, doing anything.

You see a tape recorder under the papers.

* * *

>examine keypad
There are numbers on the keypad.

"Who are you?" the Voice asks. "What is the key?" 
Type the key:

>11519
That's not a verb I recognise.

"Who are you?" the Voice asks. "What is the key?" 
Type the key:

>type 11519
That's not a verb I recognise.

"Who are you?" the Voice asks. "What is the key?" 
Type the key:

>say 11519
(to yourself)
There is no reply.

"Who are you?" the Voice asks. "What is the key?" 
Type the key:

* * *

>go north
Lab
The room is huge and brightly lit. It smells like a zoo. If you stay quiet, you can hear muffled breathing coming from somewhere...

A heavy door leads east.

A series of cages line the walls, all open.

There is a small, hand-crafted, wooden maze on a table.

A black cabinet stands near the table.

A disgusting brown cockroach sits on top of the cabinet.

Sylvester saunters into the room after you, purring and wearing a rather satisfied look on his face. You can only guess why.

>kill cockroach
You smash the cockroach with your foot. "Rather cruel, don't you think?" the Voice remarks. You ignore it and relish the fact the bug is gone.

[Your score has just gone up by three points.]

>open cabinet
A key is inside! "Well done," the Voice praises. "You should be able to go on your way."

* * *

>unlock heavy door with key
You unlock the heavy door.

>enter heavy door
(first opening the heavy door)

Experimental Room
An intimidatingly large chair sits in the center of the room. The walls are adorned with pictures of random words and drawings. 
 
Northward is an entryway...its door hangs off its hinges, almost completely shattered.

A heavy door leads to the Lab.

One drawing in the room is not of an object or person and appears to be marked with something.

You realize the quiet breathing from before is from a man sitting in the chair. He does not look at you and wears a blank expression.

>go north
Maze Room
Giant white walls stand before you, twisting and turning in T shapes. It's almost like a human-sized maze. Some blood disturbs the white.

Large holes are on the walls.

Graffiti lines the walls. You can tell from the handwriting that different people had drawn on the walls with markers and pens.

"It's funny," the Voice muses. "They had to do this damn maze all the time and always complained that they wanted to just get out...it took them a while to figure out that they could just break down the walls. They always had the chance to escape."

>squeeze through holes
A large glass-pane window is on the wall beside a door that is blocked by numerous pieces of furniture, from desk parts, table parts, even comfy chairs. "Ah. Well. Time to think of a solution," the Voice says. "Impress me."

>break window
Violence isn't the answer to this one.

>smash window
Violence isn't the answer to this one.

>examine furniture
A giant pile of furniture blocks the door.

Table legs stick out of the pile like spikes.

* * *

>smash window
Violence isn't the answer to this one.

>smash window with table leg
You hit the window with the table leg. The window splinters and breaks, giving you a sizable hole to the next room! "Well done," the Voice praises.

Research Room
A large room half-lit with flickering fluorescent lights. There are photos of men and women on the walls. A map of the human brain is also hung up.

A drawer compartment sits on the floor.

A diary sits on top of a cracked table. "Give it a read." The Voice sounded pained.

[Your score has just gone up by five points.]

>read diary
 
 
Date: September 16, 2014 
We knew it wouldn't take long for them to sniff out what we were doing. But we didn't think they would come so soon. The military wasted no time approaching the supervisor and compelling him (yes, I say compel) to make our facility's research an undercover study. 
We originally strove to find a way to enhance human memory. We failed and found a way to disintegrate it. Our trash became someone else's treasure. 
Those government dogs told us why we should continue. The memory-disintegration method, they claim, will be extraordinarily helpful for their work. POWs will forget all they have seen during their stay with the enemy when they are returned. Those who have seen too much of what lies behind the government veil will no longer be a threat. 
A good number of us have protested vigorously, but not for long, unsurprisingly. Some are thrilled by the change in objective, taking delight in the so-called "partnership" with the military. As for me, I have only the deepest of doubts about this operation. We are doing a service to our country, they said. I feel no pride in doing it. 
In the next month, we are changing the experimentation designs. To find test subjects, we are projecting ourselves to the public under a new slogan that we offer therapeutic treatment for those with mental conditions." 
 
 Entry # 2 
Date: February 6, 2016 
I am supervising the progress of one of the newest participants to arrive to our facility. His name is Sebastian Weaver, under subject number 11519. A typical severely-depressed young male who yearned to be happy. "Do good, Parr," Kevin had said, patting me on the back. I nearly punched his face. 
When I spoke to him during his interview, I wished I had just told him the truth. Just blurt out what we were really doing. But, coward that I am, I didn't. I sometimes wonder why I stay in this damn place, but it is then that I see the faces of Isabel and Joanne. Surely, since I know the truth behind our research, I know a valuable secret of the military. Surely, if I attempt to escape, they will..."deal" with me. And perhaps Isabel and Joanne as well, once they start questioning my disappearance. 
What irony...to believe that the very place I had considered my intellectual monastery is now the darkest of cells. All of us, test subjects and experimenters alike, are like the test rats in the cages of our facility. We are trapped." 
 
The rest of the pages are torn. You stifle a sigh.

"Don't let the apparent absence of memories convince you that they are completely gone. You must explore." The Voice halters. "Someone taught me that. It only took me a while to realize." 
Sylvester sits musingly near the drawer compartment on the ground.

>examine drawer compartment
In the drawer compartment are pencils, pens, a stapler and torn papers.

>read torn papers
 
Entry #5 
Date: October 6, 2016 
Subject 11519...no, Sebastian...has been walking around the facility every day for the past two months. I followed him and saw what he was doing. He was marking his travels. At that moment, I gained clarity. He was attempting to retain his memories. 
I became excited. I told Sebastian to mark his initials as well, instead of just making tally marks. I even let the cat follow him nearly all the times he walked, just as another supplement to his memory retention, a constant in his daily activity. He is the first to exhibit such behavior. And it is subtle enough that no one else would suspect him, of both of us, doing anything.

You see a tape recorder under the papers.

>listen to tape recorder
A voice speaks. It is masculine and sounds bone-weary. The voice sounds somewhat familiar. 
"So they've finally rebelled. At long last. Luckily for me, I expected it. I heard the subjects murmur under their breaths, fall silent when an experimenter walks by. But I heard them. They knew. They figured it out. 
They've done a fine job. Made every one of my colleagues run faster than I've ever seen them run. I hid in this room until the storm passed. When I ventured outside, the facility was empty. The test subjects escaped...well, most of them. There is still Subject 46, Edward Baker, and, of course...he must still be around." 
There is a hefty sigh. 
 "It's been two days since the breakout. The military hasn't arrived. If they do, they'll just find me, and two failures of test subjects. Hah. Well, my dear, dear government, how do you like that?" 
You hear the sound of a bottle swishing. The man recording must be drinking something. 
"Regardless...I'm glad. I'm not quite sure what I should do now. I considered burning this place down. Maybe I should. Make it seem like this place never existed...wipe it out of people's memories...heh! After that, I'll go home...yes, I'll go home. And make myself disappear. They can't find me. Nor my family. 
And yet...I linger here. Perhaps I've grown attached to my haven-turned-prison. A bittersweet attachment. No matter. I've stayed here for long enough. I must depart before those uniform-donning dogs arrive. 
Ah...but of course... Yes. My sliver of hope throughout all these months. The resistor. I feel the urge to watch him again...to observe his steady march through the facility...He forgets every time he does it, but he does it every day...like an automaton. 
I think...I will stay. Watch him, for one last time, before I leave this place. But this time, he won't return to his cell. He'll be gone, like the others. I'll make sure of it. 
My name is Doctor John Parr, supervising researcher at Soma Memory Labs. Date...I've lost track. Who cares. This will be my last experimental observation." 
 
 The recorder falls silent. 
 "...Yes. That's it." The Voice sounds faintly approving. "Well done. Now, look to your right. Do you see that keypad? Why don't you type in the key. You're almost done."

>examine keypad
There are numbers on the keypad.

"Who are you?" the Voice asks. "What is the key?" Type it in:

>type 11519
The keypad clicks and beeps. Suddenly, the wall slides back, revealing an entrance.

Exit
A dark room. The right wall is covered with numerous televisions, each depicting a room you have explored. 
A door is up ahead. Above it is a sign with neon-red letters: EXIT.

You can see a doctor here.

* * *

>examine doctor
A middle-aged man. He is wearing a white gown that has been dirtied. His face is haggard and his eyes droop by the weight of their bags. One lens of his glasses is cracked. He nods once and speaks. 
"You've made it. This is the 93rd time you've walked the halls of this facility, but you never ended up here. Yes, you've been experiencing amnesiac episodes, but those will pass soon enough. I've stopped treating you months ago, so you won't end up like...like Subject 14." 
His voice, although weary, sounds like the Voice. His breath reeks of alcohol. 
"Many dreams were built here. Many...memories." He grounds out the word. "It won't be long before they find us. Find me. I've stayed here for too long. And I must go." 
He cracks a small smile at you. An artificial smile. "My name is Doctor John Parr," he says in the voice of a doctor greeting a patient. The words sound familiar. As if you had heard it months ago. "Your experiment has been concluded. Thank you for your participation. We value your support and patience. But tell me..." He stops, swallows, and suddenly looks pleading. "Can...can you forgive us? For what we've done?"

>forgive doctor
    *** 
 
The doctor opens the door, revealing a flat, sandy field. Outside. "Forget I existed," he says quietly. "Forget this face. Live your life and make lasting memories. I hope you find happiness, Sebastian Weaver. Goodbye." 
 
You step outside and feel the sand under your shoes. The wind blows gently. The sun's bright and you have to squint to adjust to the glare. 
Beside you, Sylvester meows and purrs against your leg. 
Slowly, you make your way down the field, Sylvester by your side, beginning a long, long walk." ***

In that game you scored 8 out of a possible 36, in 25 turns.

Would you like to RESTART, RESTORE a saved game, QUIT or UNDO the last command?

* * *

>smash window
Violence isn't the answer to this one.

>break window with table leg
You can't see any such thing.

* * *

>examine furniture
A giant pile of furniture blocks the door.

Table legs stick out of the pile like spikes.

>take table lg
I only understood you as far as wanting to take the table leg.

>take table leg
Hmm. Could be useful somehow.

>smash window with table leg
You hit the window with the table leg. The window splinters and breaks, giving you a sizable hole to the next room! "Well done," the Voice praises.

Research Room
A large room half-lit with flickering fluorescent lights. There are photos of men and women on the walls. A map of the human brain is also hung up.

A drawer compartment sits on the floor.

A diary sits on top of a cracked table. "Give it a read." The Voice sounds stiff. "While you're at it, just try to...I suppose...understand a few things.

[Your score has just gone up by five points.]

>read diary
 
 
Date: September 16, 2014 
We knew it wouldn't take long for them to sniff out what we were doing. But we didn't think they would come so soon. The military wasted no time approaching the supervisor and compelling him (yes, I say compel) to make our facility's research an undercover study. 
We originally strove to find a way to enhance human memory. We failed and found a way to disintegrate it. Our trash became someone else's treasure. 
Those government dogs told us why we should continue. The memory-disintegration method, they claim, will be extraordinarily helpful for their work. POWs will forget all they have seen during their stay with the enemy when they are returned. Those who have seen too much of what lies behind the government veil will no longer be a threat. 
A good number of us have protested vigorously, but not for long, unsurprisingly. Some are thrilled by the change in objective, taking delight in the so-called "partnership" with the military. As for me, I have only the deepest of doubts about this operation. We are doing a service to our country, they said. I feel no pride in doing it. 
In the next month, we are changing the experimentation designs. To find test subjects, we are projecting ourselves to the public under a new slogan that we offer therapeutic treatment for those with mental conditions." 
 
 Entry # 2 
Date: February 6, 2016 
I am supervising the progress of one of the newest participants to arrive to our facility. His name is Sebastian Weaver, under subject number 11519. A typical severely-depressed young male who yearned to be happy. "Do good, Parr," Kevin had said, patting me on the back. I nearly punched his face. 
When I spoke to him during his interview, I wished I had just told him the truth. Just blurt out what we were really doing. But, coward that I am, I didn't. I sometimes wonder why I stay in this damn place, but it is then that I see the faces of Isabel and Joanne. Surely, since I know the truth behind our research, I know a valuable secret of the military. Surely, if I attempt to escape, they will..."deal" with me. And perhaps Isabel and Joanne as well, once they start questioning my disappearance. 
What irony...to believe that the very place I had considered my intellectual monastery is now the darkest of cells. All of us, test subjects and experimenters alike, are like the test rats in the cages of our facility. We are trapped." 
 
The rest of the pages are torn. You stifle a sigh.

"Don't let the apparent absence of memories convince you that they are completely gone. You must explore." The Voice halters. "Someone taught me that. It only took me a while to realize." 
Sylvester sits musingly near the drawer compartment on the ground.

* * *

>examine drawer compartment
In the drawer compartment are pencils, pens, a stapler and torn papers.

>read torn papers
 
Entry #5 
Date: October 6, 2016 
"Subject 11519...no, Sebastian...has been walking around the facility every day for the past two months. I followed him and saw what he was doing. He was marking his travels. At that moment, I gained clarity. He's attempting to retain his cognitive memory capabilities...unconsciously, perhaps, but nonetheless, that must be what he's doing! With each trek through the facility, he reinforces the spatial model of the building inside his brain. Each day he does it, he develops a sense of constancy, a habit. This simple act alone can help to ground at least some kind of memory. 
I became excited. I told Sebastian to mark his initials as well, instead of just making tally marks. I even let the cat follow him nearly all the times he walked, just as another supplement to his memory retention, a constant in his daily activity. My only fear is that the treatment will get to him soon enough and he will forget what he has been doing...I may intervene further. He is the first to exhibit such behavior. And it is subtle enough that no one else would suspect him, of both of us, doing anything." 
Your head pounds painfully. Snippets of images race through your mind. They are not unfamiliar to you...slowly, steadily, realization dawns on you.

You see a tape recorder under the papers.

>listen to tape recorder
A voice speaks. It is masculine and sounds bone-weary. The voice sounds somewhat familiar. 
"So they've finally rebelled. At long last. Luckily for me, I expected it. I heard the subjects murmur under their breaths, fall silent when an experimenter walks by. But I heard them. They knew. They figured it out. 
They've done a fine job. Made every one of my colleagues run faster than I've ever seen them run. I hid in this room until the storm passed. When I ventured outside, the facility was empty. The test subjects escaped...well, most of them. There is still Subject 46, Edward Baker, and, of course...he must still be around." 
There is a hefty sigh. 
 "It's been two days since the breakout. The military hasn't arrived. If they do, they'll just find me, and two failures of test subjects. Hah. Well, my dear, dear government, how do you like that?" 
You hear the sound of a bottle swishing. The man recording must be drinking something. 
"Regardless...I'm glad. I'm not quite sure what I should do now. I considered burning this place down. Maybe I should. Make it seem like this place never existed...wipe it out of people's memories...heh! After that, I'll go home...yes, I'll go home. And make myself disappear. They can't find me. Nor my family. 
And yet...I linger here. Perhaps I've grown attached to my haven-turned-prison. A bittersweet attachment. No matter. I've stayed here for long enough. I must depart before those uniform-donning dogs arrive. 
Ah...but of course... Yes. My sliver of hope throughout all these months. The resistor. I feel the urge to watch him again...to observe his steady march through the facility...it only took about two months, even with my intervention, before he experienced amnesiac episodes and forgot the next day what he had done, but he still walked every day...like an automaton. 
I think...I will stay. Watch him, for one last time, before I leave this place. But this time, he won't return to his cell. He'll be gone, like the others. I'll make sure of it. 
My name is Doctor John Parr, supervising researcher at Soma Memory Labs. Date...I've lost track. Who cares. This will be my last experimental observation." 
 
 The recorder falls silent. 
 "...Yes. That's it." The Voice sounds faintly approving. "Well done. Now, look to your right. Do you see that keypad? Why don't you type in the key. You're almost done."

>examine keypad
There are numbers on the keypad.

"Who are you?" the Voice asks. "What is the key?" Type it in:

>type 11519
You know the answer. The keypad clicks and beeps. Suddenly, the wall slides back, revealing an entrance.

Exit
A dark room. The right wall is covered with numerous televisions, each depicting a room you have explored. 
A door is up ahead. Above it is a sign with neon-red letters: EXIT.

You can see a doctor here.

That's not a verb I recognise.

>talk to doctor
[Your score has just gone up by four points.]

>examine doctor
A middle-aged man. He is wearing a white gown that has been dirtied. His face is haggard and his eyes droop by the weight of their bags. One lens of his glasses is cracked. You recognize him.

* * *

>go east
Equipment Area
The room is entirely trashed. Papers are scattered all over the gray floor. Westward you can see another room, lit in an ominous red color.

You see some photos that resemble X-rays, but they appear to be burnt.

A deplorable desk is here.

A bedraggled white cat sits atop the desk.

On the ground there is a fallen clipboard with some ripped pages.

>go west
Red Room
Dozens of photos of men and women alike, from young to old, hang on a wire in the air. This is a photo-developing room, it seems. To the north you can see an entrance to a brightly lit room.

There is a photo within reach, dangling precariously from a clip on the wire.

Hanging on the wall is a safelight.

Out of the corner of your eye, you see a white mouse nibbling at something near the wall.

>go east
Equipment Area
The room is entirely trashed. Papers are scattered all over the gray floor. Westward you can see another room, lit in an ominous red color.

You see some photos that resemble X-rays, but they appear to be burnt.

A deplorable desk is here.

On the ground there is a fallen clipboard with some ripped pages.

You can also see a cat here.

>examine cat
You spot a collar around the cat's neck. The cat gazes at you with wide, expressionless eyes. "They say if you stare at a cat for more than five seconds, it'll attack you," the Voice offers. You quickly turn your head away before anything can happen.

>go west
Red Room
Dozens of photos of men and women alike, from young to old, hang on a wire in the air. This is a photo-developing room, it seems. To the north you can see an entrance to a brightly lit room.

There is a photo within reach, dangling precariously from a clip on the wire.

Hanging on the wall is a safelight.

Out of the corner of your eye, you see a white mouse nibbling at something near the wall.

>turn on safelight
You turn on the safelight. It emits a dim glow and shines down on a countertop covered in photos. They're half-developed and you can only catch a glimpse of some figures in the photos: all appear to be in the presence of some white-coated individual.

[Your score has just gone up by three points.]

>turn on safelight
The safelight is already on.

>point at mouse
You nudge Sylvester with your foot, earning a growl as he leers at you over his shoulders. You quickly stab a finger at the mouse, and Sylvester's eyes widen and he immediately goes into a crouch, stalking rapidly towards the mouse. You turn away, and after a few seconds, see Sylvester silently walk away. The mouse is gone. What seems to be a brochure is on the ground where it was...

[Your score has just gone up by five points.]

>go north
Lab
The room is huge and brightly lit. It smells like a zoo. If you stay quiet, you can hear muffled breathing coming from somewhere...

A heavy door leads east.

A series of cages line the walls, all open.

There is a small, hand-crafted, wooden maze on a table.

A black cabinet stands near the table.

A disgusting brown cockroach sits on top of the cabinet.

Sylvester saunters into the room after you, purring and wearing a rather satisfied look on his face. You can only guess why.

>open cabinet
The cockroach sits on top of the cabinet and seems to be staring straight into your soul. You get the worst goosebumps. "Defeated by an insect?" the Voice speaks with a tinge of amusement. "I won't judge you."

>kill cockroach
You smash the cockroach with your foot. "Rather cruel, don't you think?" the Voice remarks. You ignore it and relish the fact the bug is gone.

[Your score has just gone up by three points.]

* * *

>unlock heavy door with key
You unlock the heavy door.

>enter heavy door
(first opening the heavy door)

Experimental Room
An intimidatingly large chair sits in the center of the room. The walls are adorned with pictures of random words and drawings. 
 
Northward is an entryway...its door hangs off its hinges, almost completely shattered.

A heavy door leads  to the Lab.

One drawing in the room is not of an object or person and appears to be marked with something.

You realize the quiet breathing from before is from a man sitting in the chair. He does not look at you and wears a blank expression.

>talk to man
The man does not seem to hear and continues to stare silently at the wall. "He won't respond," the Voice says quietly. "It's a little too late, I'm afraid." You fall silent and look at the man uneasily.

>go north
Maze Room
Giant white walls stand before you, twisting and turning in T shapes. It's almost like a human-sized maze. Some blood disturbs the white.

Large holes are on the walls.

Graffiti lines the walls. You can tell from the handwriting that different people had drawn on the walls with markers and pens.

"It's funny," the Voice muses. "They had to do this damn maze all the time and always complained that they wanted to just get out...it took them a while to figure out that they could just break down the walls. They always had the chance to escape."

>examine graffiti
Much of the graffiti are angry messages: "WE'RE NOT RATS" 
"YOU MAY MAKE ME FORGET MYSELF, BUT I WON'T FORGET YOUR FACES"

Sylvester walks through the maze with ease and carelessly steps over a tattered folder on the ground.

>examine folder
It contains a bunch of important looking papers. One in particular stands out: 
 
Subject 11519 has been exhibiting the same kind of behavior ever since his treatment. He has been traversing the entire facility, each and every room. Whenever he reaches the Experimental room, he marks the map with a tally mark and his initials. 
The subject had entered the facility as a young man who suffered from severe depression. He came after we advertised under the new motto that the military had told us to take on: "New memory therapy for your mental health." His consent form reveals that his motive for joining our project was to "Be happier." Memory loss can assist this, but we did not reveal to him the grave turnabout of our experiments, the fact that our research was meant to completely annihilate the capability to remember at all.

But Subject 11519 persists in his travels. He has indeed exhibited memory deterioration, mostly in the form of amnesiac episodes, but he still walks through the facility, makes his marks, and returns to his cell. He does not want to forget. His supervising experimenter, Dr. John Parr, is interested in his antics and insists that we do not interfere. It's worth noting that he has been acting oddly recently; he does not seem enthusiastic and prefers to keep to himself. If the subject's behavior begins to pester our research, then we will act accordingly. But for the moment, we will let him be.

Note: Humorously enough, he has a travel partner. The damn cat that always manages to escape before we can do anything to him. Perhaps they are both attempting to rebel against us?

"You've been doing well," the Voice suddenly spoke. It sounds quieter than usual. "There is a room up ahead at the end of the maze. Once you're done exploring this area, can you squeeze through the holes and get to the end of the maze?"

>squeeze through holes
A large glass-pane window is on the wall beside a door that is blocked by numerous pieces of furniture, from desk parts, table parts, even comfy chairs. "Ah. Well. Time to think of a solution," the Voice says. "Impress me."

* * *

>break window
Violence isn't the answer to this one.

>examine furniture
A giant pile of furniture blocks the door.

Table legs stick out of the pile like spikes.

>take table lge
I only understood you as far as wanting to take the table leg.

>take table leg
Hmm. Could be useful somehow.

* * *

>smash window with table leg
You hit the window with the table leg. The window splinters and breaks, giving you a sizable hole to the next room! "Well done," the Voice praises.

Research Room
A large room half-lit with flickering fluorescent lights. There are photos of men and women on the walls. A map of the human brain is also hung up.

A drawer compartment sits on the floor.

A diary sits on top of a cracked table. "Give it a read." The Voice sounded pained.

[Your score has just gone up by five points.]

>go to Maze Room
You can't see any such thing.

>enter Maze Room
You can't see any such thing.

>read diary
 
 
Date: September 16, 2014 
We knew it wouldn't take long for them to sniff out what we were doing. But we didn't think they would come so soon. The military wasted no time approaching the supervisor and compelling him (yes, I say compel) to make our facility's research an undercover study. 
We originally strove to find a way to enhance human memory. We failed and found a way to disintegrate it. Our trash became someone else's treasure. 
Those government dogs told us why we should continue. The memory-disintegration method, they claim, will be extraordinarily helpful for their work. POWs will forget all they have seen during their stay with the enemy when they are returned. Those who have seen too much of what lies behind the government veil will no longer be a threat. 
A good number of us have protested vigorously, but not for long, unsurprisingly. Some are thrilled by the change in objective, taking delight in the so-called "partnership" with the military. As for me, I have only the deepest of doubts about this operation. We are doing a service to our country, they said. I feel no pride in doing it. 
In the next month, we are changing the experimentation designs. To find test subjects, we are projecting ourselves to the public under a new slogan that we offer therapeutic treatment for those with mental conditions." 
 
 Entry # 2 
Date: February 6, 2016 
I am supervising the progress of one of the newest participants to arrive to our facility. His name is Sebastian Weaver, under subject number 11519. A typical severely-depressed young male who yearned to be happy. "Do good, Parr," Kevin had said, patting me on the back. I nearly punched his face. 
When I spoke to him during his interview, I wished I had just told him the truth. Just blurt out what we were really doing. But, coward that I am, I didn't. I sometimes wonder why I stay in this damn place, but it is then that I see the faces of Isabel and Joanne. Surely, since I know the truth behind our research, I know a valuable secret of the military. Surely, if I attempt to escape, they will..."deal" with me. And perhaps Isabel and Joanne as well, once they start questioning my disappearance. 
What irony...to believe that the very place I had considered my intellectual monastery is now the darkest of cells. All of us, test subjects and experimenters alike, are like the test rats in the cages of our facility. We are trapped." 
 
The rest of the pages are torn. You stifle a sigh.

"Don't let the apparent absence of memories convince you that they are completely gone. You must explore." The Voice halters. "Someone taught me that. It only took me a while to realize." 
Sylvester sits musingly near the drawer compartment on the ground.

* * *

>examine drawer compartment
In the drawer compartment are pencils, pens, a stapler and torn papers.

>read torn papers
 
Entry #5 
Date: October 6, 2016 
Subject 11519...no, Sebastian...has been walking around the facility every day for the past two months. I followed him and saw what he was doing. He was marking his travels. At that moment, I gained clarity. He's attempting to retain his cognitive memory capabilities...unconsciously, perhaps, but nonetheless, that must be what he's doing! With each trek through the facility, he reinforces the spatial model of the building inside his brain. Each day he does it, he develops a sense of constancy, a habit. This simple act alone can help to ground at least some kind of memory. 
I became excited. I told Sebastian to mark his initials as well, instead of just making tally marks. I even let the cat follow him nearly all the times he walked, just as another supplement to his memory retention, a constant in his daily activity. My only fear is that the treatment will get to him soon enough and he will forget what he has been doing...I may intervene further. He is the first to exhibit such behavior. And it is subtle enough that no one else would suspect him, of both of us, doing anything.

You see a tape recorder under the papers.

>listen to tape recorder
A voice speaks. It is masculine and sounds bone-weary. The voice sounds somewhat familiar. 
"So they've finally rebelled. At long last. Luckily for me, I expected it. I heard the subjects murmur under their breaths, fall silent when an experimenter walks by. But I heard them. They knew. They figured it out. 
They've done a fine job. Made every one of my colleagues run faster than I've ever seen them run. I hid in this room until the storm passed. When I ventured outside, the facility was empty. The test subjects escaped...well, most of them. There is still Subject 46, Edward Baker, and, of course...he must still be around." 
There is a hefty sigh. 
 "It's been two days since the breakout. The military hasn't arrived. If they do, they'll just find me, and two failures of test subjects. Hah. Well, my dear, dear government, how do you like that?" 
You hear the sound of a bottle swishing. The man recording must be drinking something. 
"Regardless...I'm glad. I'm not quite sure what I should do now. I considered burning this place down. Maybe I should. Make it seem like this place never existed...wipe it out of people's memories...heh! After that, I'll go home...yes, I'll go home. And make myself disappear. They can't find me. Nor my family. 
And yet...I linger here. Perhaps I've grown attached to my haven-turned-prison. A bittersweet attachment. No matter. I've stayed here for long enough. I must depart before those uniform-donning dogs arrive. 
Ah...but of course... Yes. My sliver of hope throughout all these months. The resistor. I feel the urge to watch him again...to observe his steady march through the facility...it only took about two months, even with my intervention, before he experienced amnesiac episodes and forgot the next day what he had done, but he still walked every day...like an automaton. 
I think...I will stay. Watch him, for one last time, before I leave this place. But this time, he won't return to his cell. He'll be gone, like the others. I'll make sure of it. 
My name is Doctor John Parr, supervising researcher at Soma Memory Labs. Date...I've lost track. Who cares. This will be my last experimental observation." 
 
 The recorder falls silent. 
 "...Yes. That's it." The Voice sounds faintly approving. "Well done. Now, look to your right. Do you see that keypad? Why don't you type in the key. You're almost done."

* * *

>examine keypad
There are numbers on the keypad.

"Who are you?" the Voice asks. "What is the key?" Type it in:

>type 1132
Incorrect. "You know who you are," the Voice says firmly. "Tell me."

>examine keypad
There are numbers on the keypad.

"Who are you?" the Voice asks. "What is the key?" Type it in:

>type 11519
The keypad clicks and beeps. Suddenly, the wall slides back, revealing an entrance.

Exit
A dark room. The right wall is covered with numerous televisions, each depicting a room you have explored. 
A door is up ahead. Above it is a sign with neon-red letters: EXIT.

You can see a doctor here.

That's not a verb I recognise.

"Who are you?" the Voice asks. "What is the key?" Type it in:

>talk to doctor
Incorrect. "You know who you are," the Voice says firmly. "Tell me."

* * *

>go west
Equipment Area
The room is entirely trashed. Papers are scattered all over the gray floor. Westward you can see another room, lit in an ominous red color.

You see some photos that resemble X-rays, but they appear to be burnt.

A deplorable desk is here.

A bedraggled white cat sits atop the desk.

On the ground there is a fallen clipboard with some ripped pages.

The cat stares at you with beady yellow eyes. 
"That's Sylvester." You jump, startled, as you hear the artificial Voice echo in the room you're in. "He's quite a friendly cat. He enjoys a nice touch on the head."

>go north
You can't go that way.

>go west
Red Room
Dozens of photos of men and women alike, from young to old, hang on a wire in the air. This is a photo-developing room, it seems. To the north you can see an entrance to a brightly lit room.

There is a photo within reach, dangling precariously from a clip on the wire.

Hanging on the wall is a safelight.

Out of the corner of your eye, you see a white mouse nibbling at something near the wall.

Sylvester scampers into the room and looks at you meaningfully. "He seems to take a liking to you," the Voice remarks. Sylvester turns and faces the entrance you just came from, grooming himself.

>go north
Lab
The room is huge and brightly lit. It smells like a zoo. If you stay quiet, you can hear muffled breathing coming from somewhere...

A heavy door leads east.

A series of cages line the walls, all open.

There is a small, hand-crafted, wooden maze on a table.

A black cabinet stands near the table. One of its drawers juts out slightly.

A disgusting brown cockroach sits on top of the cabinet.

Sylvester saunters into the room after you, purring and wearing a rather satisfied look on his face. You can only guess why.

>open cabinet
A key is inside! "Well done," the Voice praises. "You should be able to go on your way."

* * *

>smash window with table leg
You hit the window with the table leg. The window splinters and breaks, giving you a sizable hole to the next room! "Well done," the Voice praises.

Research Room
A large room half-lit with flickering fluorescent lights. There are photos of men and women on the walls. A map of the human brain is also hung up.

A drawer compartment sits on the floor.

A diary sits on top of a cracked table. "Give it a read." The Voice sounded pained.

>examine diary
 
 
Date: September 16, 2014 
We knew it wouldn't take long for them to sniff out what we were doing. But we didn't think they would come so soon. The military wasted no time approaching the supervisor and compelling him (yes, I say compel) to make our facility's research an undercover study. 
We originally strove to find a way to enhance human memory. We failed and found a way to disintegrate it. Our trash became someone else's treasure. 
Those government dogs told us why we should continue. The memory-disintegration method, they claim, will be extraordinarily helpful for their work. POWs will forget all they have seen during their stay with the enemy when they are returned. Those who have seen too much of what lies behind the government veil will no longer be a threat. 
A good number of us have protested vigorously, but not for long, unsurprisingly. Some are thrilled by the change in objective, taking delight in the so-called "partnership" with the military. As for me, I have only the deepest of doubts about this operation. We are doing a service to our country, they said. I feel no pride in doing it. 
In the next month, we are changing the experimentation designs. To find test subjects, we are projecting ourselves to the public under a new slogan that we offer therapeutic treatment for those with mental conditions." 
 
 Entry # 2 
Date: February 6, 2016 
I am supervising the progress of one of the newest participants to arrive to our facility. His name is Sebastian Weaver, under subject number 11519. A typical severely-depressed young male who yearned to be happy. "Do good, Parr," Kevin had said, patting me on the back. I nearly punched his face. 
When I spoke to him during his interview, I wished I had just told him the truth. Just blurt out what we were really doing. But, coward that I am, I didn't. I sometimes wonder why I stay in this damn place, but it is then that I see the faces of Isabel and Joanne. Surely, since I know the truth behind our research, I know a valuable secret of the military. Surely, if I attempt to escape, they will..."deal" with me. And perhaps Isabel and Joanne as well, once they start questioning my disappearance. 
What irony...to believe that the very place I had considered my intellectual monastery is now the darkest of cells. All of us, test subjects and experimenters alike, are like the test rats in the cages of our facility. We are trapped." 
 
The rest of the pages are torn.

"Those were memories. Don't let the apparent absence of memories convince you that they are completely gone. You must explore." The Voice halters. "Someone taught me that. It only took me a while to realize." 
Sylvester sits musingly near the drawer compartment on the ground.

>examine drawer compartment
In the drawer compartment are pencils, pens, a stapler and torn papers.

>examine torn papers
 
 Entry #5 
 Date: October 6, 2016 
 Subject 11519...no, Sebastian...has been walking around the facility every day for the past two months. I followed him and saw what he was doing. He was marking his travels. At that moment, I gained clarity. He was attempting to retain his memories. 
 I became excited. I told Sebastian to mark his initials as well, instead of just making tally marks. I even let the cat follow him nearly all the times he walked, just as another supplement to his memory retention, a constant in his daily activity. He is the first to exhibit such behavior. And it is subtle enough that no one else would suspect him, of both of us, doing anything.

You see a tape recorder under the papers.

>listen to tape recorder
A voice speaks. It is masculine and sounds bone-weary. The voice sounds somewhat familiar. 
"So they've finally rebelled. At long last. Luckily for me, I expected it. I heard the subjects murmur under their breaths, fall silent when an experimenter walks by. But I heard them. They knew. They figured it out 
They've done a fine job. Made every one of my colleagues run faster than I've ever seen them run. I hid in this room until the storm passed. When I ventured outside, the facility was empty. The test subjects escaped...well, most of them. There is still Subject 46, Edward Baker, and, of course...he must still be around." 
There is a hefty sigh. 
 "It's been two days since the breakout. The military hasn't arrived. If they do, they'll just find me, and two failures of test subjects. Hah. Well, my dear, dear government, how do you like that?" 
You hear the sound of a bottle swishing. The man recording must be drinking something. 
"Regardless...I'm glad. I'm not quite sure what I should do now. I considered burning this place down. Maybe I should. Make it seem like this place never existed...wipe it out of people's memories...heh! After that, I'll go home...yes, I'll go home. And make myself disappear. They can't find me. Nor my family. 
And yet...I linger here. Perhaps I've grown attached to my haven-turned-prison. A bittersweet attachment. No matter. I've stayed here for long enough. I must depart before those uniform-donning dogs arrive. 
Ah...but of course... Yes. My sliver of hope throughout all these months. The resistor. I feel the urge to watch him again...to observe his steady march through the facility...He forgets every time he does it, but he does it every day...like an automaton. 
I think...I will stay. Watch him, for one last time, before I leave this place. But this time, he won't return to his cell. He'll be gone, like the others. I'll make sure of it. 
My name is Doctor John Parr, supervising researcher at Soma Memory Labs. Date...I've lost track. Who cares. This will be my last experimental observation." 
 
 The recorder falls silent. 
 "...Yes. That's it." The Voice sounds faintly approving. "Well done. Do you see that keypad to your right? Why don't you type in the key. You're almost done."

* * *

>examine keypad
There are numbers on the keypad.

"Who are you?" the Voice asks. "What is the key?":

>type 11519
The keypad clicks and beeps. Suddenly, the wall slides back, revealing an entrance.

Exit
A dark room. The right wall is covered with numerous televisions, each depicting a room you have explored.

A door is up ahead. Above it is a sign with neon-red letters: EXIT. A middle-aged man stands near a door. He is wearing a white gown that has been dirtied. His face is haggard and his eyes droop by the weight of their bags. One lens of his glasses is cracked.

You can also see Doctor John Parr here.

>examine Doctor John Parr
He nods once and speaks. "You've made it. This is the 93rd time you've walked the halls of this facility, but you never ended up here. Yes, you've been experiencing amnesiac episodes, but those will pass soon enough. I've stopped treating you months ago, so you won't end up like...like Subject 14." 
 His voice, although weary, sounds like the Voice. His breath reeks of alcohol. 
 "Many dreams were built here. Many...memories." He grounds out the word. "It won't be long before they find us. Find me. I've stayed here for too long. And I must go." 
 He cracks a small smile at you. An artificial smile. "My name is Doctor John Parr," he says in a voice of a doctor greeting a patient. It sounds familiar. "Your experiment has been concluded. Thank you for your participation. We value your support and patience." 
 The doctor opens the door, revealing a flat, sandy field. Outside. "Forget I existed," he says quietly. "Forget this face. Live your life and make lasting memories. I hope you become happy, Sebastian Weaver." Goodbye.

>enter door
You can't, since the exit door leads nowhere.

>enter exit door
You can't, since the exit door leads nowhere.

* * *

>unlock heavy door with key
You unlock the heavy door.

>open heavy door
You open the heavy door.

>enter heavy door
Experimental Room
An intimidatingly large chair sits in the center of the room. The walls are adorned with pictures of words and drawings. 
Up ahead is an entryway...its door hangs off its hinges, almost completely shattered.

Nearby a heavy door leads west to the Lab.

One drawing is not of an object or person.

You realize the quiet breathing from before is from a man sitting in the chair. He does not look at you and wears a blank expression.

>go north
Maze Room
Giant white walls. It's almost like a human-sized maze. Some blood disturbs the white.

Large holes are on the walls.

Graffiti lines the walls. It looks as if different people had written haphazardly on them.

"It's funny," the Voice muses. "They had to do this damn maze all the time and always complained that they wanted to just get out...it took them a while to figure out that they could just break down the walls. They always had the chance to escape."

* * *

>examine graffiti
Much of the graffiti are angry messages: "WE'RE NOT RATS" 
 "YOU MAY MAKE ME FORGET MYSELF, BUT I WON'T FORGET YOUR FACES"

Sylvester walks through the maze with ease and carelessly steps over a tattered folder on the ground.

>pick up tattered folder
You can't see any such thing.

>examine folder
It contains a bunch of important looking papers. One in particular stands out: 
 
Subject 11519 has been exhibiting the same kind of behavior ever since his treatment. He has been traversing the entire facility, each and every room. Whenever he reaches the Experimental room, he marks the map with a tally mark and his initials.
 
The subject had entered the facility as a young man who suffered from severe depression. He came after we advertised under the new motto that the military had told us to take on: "New memory therapy for your mental health." His consent form reveals that his motive for joining our project was to "Be happier." Memory loss can assist this, but we did not reveal to him the grave turnabout of our experiments, the fact that our research was meant to completely annihilate the capability to remember at all.
 
But Subject 11519 persists in his travels. He has indeed exhibited memory deterioration, mostly in the form of amnesiac episodes, but he still walks through the facility, makes his marks, and returns to his cell. He does not want to forget. His supervising experimenter, Dr. John Parr, is interested in his antics and insists that we do not interfere. It's worth noting that he has been acting oddly recently; he does not seem enthusiastic and prefers to keep to himself. If 11519"s behavior begins to pester our research, then we will act accordingly. But for the moment, we will let him be.
 
Note: Humorously enough, he has a travel partner. The damn cat that always manages to escape before we can do anything to him. Perhaps they are both attempting to rebel against us?

"You've been doing well," the Voice suddenly spoke. It sounds quieter than usual. "There is a room up ahead at the end of the maze. Once you're done exploring this area, can you squeeze through the holes and get to the end of the maze?"

>squeeze through holes
A large glass-pane window is on the wall beside a door that is blocked by numerous pieces of furniture, from desk parts, table parts, even comfy chairs. "Ah. Well. Time to think of a solution," the Voice says. "Impress me."

* * *

>examine keypad
There are numbers on the keypad.

"Who are you?" the Voice asks. "What is the key?":

>blah
Incorrect. "You know who you are," the Voice says firmly. "Tell me."

>examine keypad
There are numbers on the keypad.

"Who are you?" the Voice asks. "What is the key?":

* * *

>type 11519
The keypad clicks and beeps. Suddenly, the wall slides back, revealing an entrance.

Exit
A dark room. The right wall is covered with numerous televisions, each depicting a room you have explored. 
A door is up ahead. Above it is a sign with neon-red letters: EXIT.

You can see a doctor here.

>examine doctor
You see nothing special about the doctor.

* * *

>go north
Lab
The room is huge and brightly lit. It smells like a zoo. If you stay quiet, you can hear muffled breathing coming from somewhere...

A heavy door leads east.

A series of cages line the walls, all open.

There is a small, hand-crafted, wooden maze on a table.

A black cabinet stands near the table. One of its drawers juts out slightly.

A disgusting brown cockroach sits on top of the cabinet.

Sylvester saunters into the room after you, purring and wearing a rather satisfied look on his face. You can only guess why.

>kill cockroach
You smash the cockroach with your foot. "Rather cruel, don't you think?" the Voice remarks. You ignore it and relish the fact the bug is gone.

[Your score has just gone up by three points.]

* * *

>unlock heavy door
You unlock the heavy door.

>enter heavy door
(first opening the heavy door)

Experimental Room
An intimidatingly large chair sits in the center of the room. The walls are adorned with pictures of random words and drawings. 
 
Northward is an entryway...its door hangs off its hinges, almost completely shattered.

A heavy door leads to the Lab.

One drawing in the room is not of an object or person and appears to be marked with something.

You realize the quiet breathing from before is from a man sitting in the chair. He does not look at you and wears a blank expression.

* * *

>examine keypad
There are numbers on the keypad.

"Who are you?" the Voice asks. "What is the key?" 
Type it in:

>11519
That's not a verb I recognise.

"Who are you?" the Voice asks. "What is the key?" 
Type it in:

>type 11519
That's not a verb I recognise.

"Who are you?" the Voice asks. "What is the key?" 
Type it in:

* * *

>examine drawer compartment
In the drawer compartment are pencils, pens, a stapler and torn papers.

>read torn papers
 
Entry #5 
Date: October 6, 2016 
"Subject 11519...no, Sebastian...has been walking around the facility every day for the past two months. I followed him and saw what he was doing. He was marking his travels. At that moment, I gained clarity. He's attempting to retain his cognitive memory capabilities...unconsciously, perhaps, but nonetheless, that must be what he's doing! With each trek through the facility, he reinforces the spatial model of the building inside his brain. Each day he does it, he develops a sense of constancy, a habit. This simple act alone can help to ground at least some kind of memory. 
I became excited. I told Sebastian to mark his initials as well, instead of just making tally marks. I even let the cat follow him nearly all the times he walked, just as another supplement to his memory retention, a constant in his daily activity. My only fear is that the treatment will get to him soon enough and he will forget what he has been doing...I may intervene further. He is the first to exhibit such behavior. And it is subtle enough that no one else would suspect him, of both of us, doing anything." 
 
Your head pounds painfully. Snippets of images race through your mind. They are not unfamiliar to you...slowly, steadily, realization dawns on you.

You see a tape recorder under the papers.

>listen to tape recorder
A voice speaks. It is masculine and sounds bone-weary. The voice sounds somewhat familiar. 
"So they've finally rebelled. At long last. Luckily for me, I expected it. I heard the subjects murmur under their breaths, fall silent when an experimenter walks by. But I heard them. They knew. They figured it out. 
They've done a fine job. Made every one of my colleagues run faster than I've ever seen them run. I hid in this room until the storm passed. When I ventured outside, the facility was empty. The test subjects escaped...well, most of them. There is still Subject 46, Edward Baker, and, of course...he must still be around." 
There is a hefty sigh. 
 "It's been two days since the breakout. The military hasn't arrived. If they do, they'll just find me, and two failures of test subjects. Hah. Well, my dear, dear government, how do you like that?" 
You hear the sound of a bottle swishing. The man recording must be drinking something. 
"Regardless...I'm glad. I'm not quite sure what I should do now. I considered burning this place down. Maybe I should. Make it seem like this place never existed...wipe it out of people's memories...heh! After that, I'll go home...yes, I'll go home. And make myself disappear. They can't find me. Nor my family. 
And yet...I linger here. Perhaps I've grown attached to my haven-turned-prison. A bittersweet attachment. No matter. I've stayed here for long enough. I must depart before those uniform-donning dogs arrive. 
Ah...but of course... Yes. My sliver of hope throughout all these months. The resistor. I feel the urge to watch him again...to observe his steady march through the facility...it only took about two months, even with my intervention, before he experienced amnesiac episodes and forgot the next day what he had done, but he still walked every day...like an automaton. 
I think...I will stay. Watch him, for one last time, before I leave this place. But this time, he won't return to his cell. He'll be gone, like the others. I'll make sure of it. 
My name is Doctor John Parr, supervising researcher at Soma Memory Labs. Date...I've lost track. Who cares. This will be my last experimental observation." 
 
 The recorder falls silent. 
 "...Yes. That's it." The Voice sounds faintly approving. "Well done. Now, look to your right. Do you see that keypad? Why don't you type in the key. You're almost done."

* * *

>examine keypad
There are numbers on the keypad.

"Who are you?" the Voice asks. "What is the key?" Type it in:

>type 1519
Incorrect. "You know who you are," the Voice says firmly. "Tell me."

* * *

>examine keypad
There are numbers on the keypad.

"Who are you?" the Voice asks. "What is the key?" Type it in:

>type 11519
You know the answer. The keypad clicks and beeps. Suddenly, the wall slides back, revealing an entrance.

Exit
A dark room. The right wall is covered with numerous televisions, each depicting a room you have explored. 
A door is up ahead. Above it is a sign with neon-red letters: EXIT.

You can see a doctor here.

[Your score has just gone up by four points.]

>talk to doctor
He nods once and speaks. 
"You've made it. This is the 93rd time you've walked the halls of this facility, but you never ended up here. Yes, you've been experiencing amnesiac episodes for a while, but those will pass soon enough. I've stopped treating you months ago. So you won't end up like...like Subject 14." 
His voice, although weary, sounds like the Voice. His breath reeks of alcohol. 
"Many dreams were built here. Many...memories." He grounds out the word. "It won't be long before they find us. Find me. I've stayed here for too long. And I must go." 
He cracks a small smile at you. An artificial smile. "My name is Doctor John Parr," he says in the voice of a doctor greeting a patient. The words sound familiar. As if you had heard it months ago. "Your experiment has been concluded. Thank you for your participation. We value your support and patience. But tell me..." He stops, swallows, and suddenly looks pleading. "Can...can you forgive us? For what we've done?"

>forgive doctor
    *** 
 
The doctor opens the door, revealing a flat, sandy field. Outside. "Forget I existed," he says quietly. "Forget this face. Live your life and make lasting memories. I hope you find happiness, Sebastian Weaver. Goodbye." 
 
You step outside and feel the sand under your shoes. The wind blows gently. The sun's bright and you have to squint to adjust to the glare. 
Beside you, Sylvester meows and purrs against your leg. 
Slowly, you make your way down the field, Sylvester by your side, beginning a long, long walk. ***

In that game you scored 12 out of a possible 64, in 25 turns.

Would you like to RESTART, RESTORE a saved game, QUIT or UNDO the last command?

* * *

>go west
Equipment Area
The room is entirely trashed. Papers are scattered all over the gray floor. Westward you can see another room, lit in an ominous red color.

You see some photos that resemble X-rays, but they appear to be burnt.

A deplorable desk is here.

A bedraggled white cat sits atop the desk.

On the ground there is a fallen clipboard with some ripped pages.

The cat stares at you with beady yellow eyes. 
"That's Sylvester." You jump, startled, as you hear the artificial Voice echo in the room you're in. "He's quite a friendly cat. He enjoys a nice touch on the head."

>touch Sylvester
Sylvester seems relaxed and complacent. His collar is right under your hand. Maybe you can take a closer look at it.

>go west
Red Room
Dozens of photos of men and women alike, from young to old, hang on a wire in the air. This is a photo-developing room, it seems. To the north you can see an entrance to a brightly lit room.

There is a photo within reach, dangling precariously from a clip on the wire.

Out of the corner of your eye, you see a white mouse nibbling at something near the wall.

* * *

>go north
Lab
The room is huge and brightly lit. It smells like a zoo. If you stay quiet, you can hear muffled breathing coming from somewhere...

A heavy door leads east.

A series of cages line the walls, all open.

There is a small, hand-crafted, wooden maze on a table.

A black cabinet stands near the table.

A cockroach sits placidly on the cabinet surface.

Sylvester saunters into the room after you, purring and wearing a rather satisfied look on his face. You can only guess why.

>open cabinet
The cockroach seems to be staring straight into your soul, and you get the worst goosebumps. "Defeated by an insect?" the Voice speaks with a tinge of amusement. "I won't judge you."

>kill cockroach
You smash the cockroach with your foot. "Rather cruel, don't you think?" the Voice remarks. You ignore it and relish the fact the bug is gone.

[Your score has just gone up by three points.]

* * *

>unlock heavy door with key
You unlock the heavy door.

>enter heavy door
(first opening the heavy door)

Experimental Room
An intimidatingly large chair sits in the center of the room. The walls are adorned with pictures of random words and drawings. 
 
Northward is an entryway...its door hangs off its hinges, almost completely shattered.

A heavy door leads  to the Lab.

One drawing is not of an object or person and appears to be marked with something.

You realize the quiet breathing from before is from a man sitting in the chair. He does not look at you and wears a blank expression.

>talk to man
That's not a verb I recognise.

>talking to man
The man does not seem to hear and continues to stare silently at the wall. "He won't respond," the Voice says quietly.

>examine man
A document and photograph are crumpled in the man's hand.

>take document
Taken.

>examine document
It's an official document: 
SOMA MEMORY LABS 
143-21 East Drive, SC, CA 
 Date: June 10, 2013 
SUBJECT NAME: 14 (John Akins) 
Age: 43 
Length of Stay: 10 months
 
Subject 14 arrived at the facility as a healthy middle-aged male with average memory skills. He performed well in the maze tasks and made few errors in recollection games. 
After being subjected to the treatment, Subject 14 exhibited gradual memory deterioration, as expected, but at a slower rate than the animals. He made errors in the mazes that he had been trained to do for months. 
By month 4, his short-term memory worsened to a time capacity of roughly 13 seconds. He struggled in recognizing the faces of his experimenters. 
By month 7, he failed to recognize a photo of himself, as well as his family members. 
By month 9, he fiercely demanded to be let out of the facility. We tacitly refused. There is a reason why the experiment went awry, and he is a valuable subject in our attempts to fix the issue. We've been working for years on this project; it's preposterous that the outcome completely counters our goals. For the moment, we will ask him to continue his participation in the memory tasks. Perhaps we may have to expand the types of tasks our subjects perform to get to the heart of the issue. I heard of a suggestion for a human-sized maze. Interesting proposition."

>examine document
It's an official document: 
SOMA MEMORY LABS 
143-21 East Drive, SC, CA 
 Date: June 10, 2013 
SUBJECT NAME: 14 (John Akins) 
Age: 43 
Length of Stay: 10 months
 
Subject 14 arrived at the facility as a healthy middle-aged male with average memory skills. He performed well in the maze tasks and made few errors in recollection games. 
After being subjected to the treatment, Subject 14 exhibited gradual memory deterioration, as expected, but at a slower rate than the animals. He made errors in the mazes that he had been trained to do for months. 
By month 4, his short-term memory worsened to a time capacity of roughly 13 seconds. He struggled in recognizing the faces of his experimenters. 
By month 7, he failed to recognize a photo of himself, as well as his family members. 
By month 9, he fiercely demanded to be let out of the facility. We tacitly refused. There is a reason why the experiment went awry, and he is a valuable subject in our attempts to fix the issue. We've been working for years on this project; it's preposterous that the outcome completely counters our goals. For the moment, we will ask him to continue his participation in the memory tasks. Perhaps we may have to expand the types of tasks our subjects perform to get to the heart of the issue. I heard of a suggestion for a human-sized maze. Interesting proposition."

>go north
Maze Room
Giant white walls. It's almost like a human-sized maze. Some blood disturbs the white.

Large holes are on the walls.

Graffiti lines the walls. It looks as if different people had written haphazardly on them.

"It's funny," the Voice muses. "They had to do this damn maze all the time and always complained that they wanted to just get out...it took them a while to figure out that they could just break down the walls. They always had the chance to escape."

* * *

>examine graffiti
Much of the graffiti are angry messages: "WE'RE NOT RATS" 
 "YOU MAY MAKE ME FORGET MYSELF, BUT I WON'T FORGET YOUR FACES"

Sylvester walks through the maze with ease and carelessly steps over a tattered folder on the ground.

>squeeze through holes
A large glass-pane window is on the wall beside a door that is blocked by numerous pieces of furniture, from desk parts, table parts, even comfy chairs. "Ah. Well. Time to think of a solution," the Voice says. "Impress me."

* * *

>examine furniture
A giant pile of furniture blocks the door.

Table legs stick out of the pile like spikes.

>examine window
It's made of glass. Hmm...

>smash window
Violence isn't the answer to this one.

* * *

>examine collar
It has the letters "--MORY LABS." Some letters are blurred out. The initials "S.W." are scrawled on it.

[Your score has just gone up by five points.]

>take collar
That seems to belong to Sylvester.

>go west
Red Room
Dozens of photos of men and women alike, from young to old, hang on a wire in the air. This is a photo-developing room, it seems. To the north you can see an entrance to a brightly lit room.

There is a photo within reach, dangling precariously from a clip on the wire.

Out of the corner of your eye, you see a white mouse nibbling at something near the wall.

>point at mouse
You nudge Sylvester with your foot, earning a growl as he looks over his shoulder at you. You quickly stab a finger at the mouse, and Sylvester's eyes widen and he immediately goes into a crouch, stalking rapidly towards the mouse. You turn away, and after a few seconds, see Sylvester silently walk away. The mouse is gone. What seems to be a brochure is on the ground where it was...

[Your score has just gone up by five points.]

>go north
Lab
The room is huge and brightly lit. It smells like a zoo. If you stay quiet, you can hear muffled breathing coming from somewhere...

A heavy door leads east.

A series of cages line the walls, all open.

There is a small, hand-crafted, wooden maze on a table.

A black cabinet stands near the table.

A disgusting brown cockroach sits on top of the cabinet.

Sylvester saunters into the room after you, purring and wearing a rather satisfied look on his face. You can only guess why.

>go south
Red Room
Dozens of photos of men and women alike, from young to old, hang on a wire in the air. This is a photo-developing room, it seems. To the north you can see an entrance to a brightly lit room.

There is a photo within reach, dangling precariously from a clip on the wire.

You can also see a brochure here.

>go north
Lab
The room is huge and brightly lit. It smells like a zoo. If you stay quiet, you can hear muffled breathing coming from somewhere...

A heavy door leads east.

A series of cages line the walls, all open.

There is a small, hand-crafted, wooden maze on a table.

A black cabinet stands near the table.

A disgusting brown cockroach sits on top of the cabinet.

>examine cabinet
You see nothing special about the cabinet.

>open cabinet
The cockroach sits on top of the cabinet and seems to be staring straight into your soul. You get the worst goosebumps. "Defeated by an insect?" the Voice speaks with a tinge of amusement. "I won't judge you."

* * *

>enter heavy door
(first opening the heavy door)

Experimental Room
An intimidatingly large chair sits in the center of the room. The walls are adorned with pictures of random words and drawings. 
 
Northward is an entryway...its door hangs off its hinges, almost completely shattered.

A heavy door leads  to the Lab.

One drawing is not of an object or person and appears to be marked with something.

You realize the quiet breathing from before is from a man sitting in the chair. He does not look at you and wears a blank expression.

>talk to man
The man does not seem to hear and continues to stare silently at the wall. "He won't respond," the Voice says quietly. "It's a little too late, I'm afraid."

>go north
Maze Room
Giant white walls stand before you, twisting and turning in T shapes. It's almost like a human-sized maze. Some blood disturbs the white.

Large holes are on the walls.

Graffiti lines the walls. You can tell from the handwriting that different people had drawn on the walls with markers and pens.

"It's funny," the Voice muses. "They had to do this damn maze all the time and always complained that they wanted to just get out...it took them a while to figure out that they could just break down the walls. They always had the chance to escape."

* * *

>take table leg
Hmm. Could be useful somehow.

>break window with table leg
You hit the window with the table leg. The window splinters and breaks, giving you a sizable hole to the next room! "Well done," the Voice praises.

Research Room
A large room half-lit with flickering fluorescent lights. There are photos of men and women on the walls. A map of the human brain is also hung up.

A drawer compartment sits on the floor.

A diary sits on top of a cracked table. "Give it a read." The Voice sounded pained.

[Your score has just gone up by five points.]

>read diary
 
 
Date: September 16, 2014 
We knew it wouldn't take long for them to sniff out what we were doing. But we didn't think they would come so soon. The military wasted no time approaching the supervisor and compelling him (yes, I say compel) to make our facility's research an undercover study. 
We originally strove to find a way to enhance human memory. We failed and found a way to disintegrate it. Our trash became someone else's treasure. 
Those government dogs told us why we should continue. The memory-disintegration method, they claim, will be extraordinarily helpful for their work. POWs will forget all they have seen during their stay with the enemy when they are returned. Those who have seen too much of what lies behind the government veil will no longer be a threat. 
A good number of us have protested vigorously, but not for long, unsurprisingly. Some are thrilled by the change in objective, taking delight in the so-called "partnership" with the military. As for me, I have only the deepest of doubts about this operation. We are doing a service to our country, they said. I feel no pride in doing it. 
In the next month, we are changing the experimentation designs. To find test subjects, we are projecting ourselves to the public under a new slogan that we offer therapeutic treatment for those with mental conditions." 
 
 Entry # 2 
Date: February 6, 2016 
I am supervising the progress of one of the newest participants to arrive to our facility. His name is Sebastian Weaver, under subject number 11519. A typical severely-depressed young male who yearned to be happy. "Do good, Parr," Kevin had said, patting me on the back. I nearly punched his face. 
When I spoke to him during his interview, I wished I had just told him the truth. Just blurt out what we were really doing. But, coward that I am, I didn't. I sometimes wonder why I stay in this damn place, but it is then that I see the faces of Isabel and Joanne. Surely, since I know the truth behind our research, I know a valuable secret of the military. Surely, if I attempt to escape, they will..."deal" with me. And perhaps Isabel and Joanne as well, once they start questioning my disappearance. 
What irony...to believe that the very place I had considered my intellectual monastery is now the darkest of cells. All of us, test subjects and experimenters alike, are like the test rats in the cages of our facility. We are trapped." 
 
The rest of the pages are torn.

"Those were memories. Don't let the apparent absence of memories convince you that they are completely gone. You must explore." The Voice halters. "Someone taught me that. It only took me a while to realize." 
Sylvester sits musingly near the drawer compartment on the ground.

>listen to tape recorder
You can't see any such thing.

>examine drawer compartment
In the drawer compartment are pencils, pens, a stapler and torn papers.

* * *

>examine keypad
There are numbers on the keypad.

"Who are you?" the Voice asks. "What is the key?" 
Type it in:

>type 11519
That's not a verb I recognise.

"Who are you?" the Voice asks. "What is the key?" 
Type it in:

* * *

>go west
Equipment Area
The room is entirely trashed. Papers are scattered all over the gray floor. Westward you can see another room, lit in an ominous red color.

You see some photos that resemble X-rays, but they appear to be burnt.

A deplorable desk is here.

A bedraggled white cat sits atop the desk.

On the ground there is a fallen clipboard with some ripped pages.

The cat stares at you with beady yellow eyes. 
"That's Sylvester." You jump, startled, as you hear the artificial Voice echo in the room you're in. "He's quite a friendly cat. He enjoys a nice touch on the head."

>touch Sylveste
You can't see any such thing.

>go west
Red Room
Dozens of photos of men and women alike, from young to old, hang on a wire in the air. This is a photo-developing room, it seems. To the north you can see an entrance to a brightly lit room.

There is a photo within reach, dangling precariously from a clip on the wire.

Out of the corner of your eye, you see a white mouse nibbling at something near the wall.

>go north
Lab
The room is huge and brightly lit. It smells like a zoo. If you stay quiet, you can hear muffled breathing coming from somewhere...

A heavy door leads east.

A series of cages line the walls, all open.

There is a small, hand-crafted, wooden maze on a table.

A black cabinet stands near the table.

You can also see a cockroach here.

Sylvester saunters into the room after you, purring and wearing a rather satisfied look on his face. You can only guess why.

>kill cockroach
You smash the cockroach with your foot. "Rather cruel, don't you think?" the Voice remarks. You ignore it and relish the fact the bug is gone.

[Your score has just gone up by three points.]

* * *

>enter heavy door
(first opening the heavy door)

Experimental Room
An intimidatingly large chair sits in the center of the room. The walls are adorned with pictures of random words and drawings. 
 
Northward is an entryway...its door hangs off its hinges, almost completely shattered.

A heavy door leads  to the Lab.

One drawing is not of an object or person and appears to be marked with something.

You realize the quiet breathing from before is from a man sitting in the chair. He does not look at you and wears a blank expression.

>talk to man
The man does not seem to hear and continues to stare silently at the wall. "He won't respond," the Voice says quietly. "It's a little too late, I'm afraid.

>go to Lab
You can't see any such thing.

>enter heavy door
Lab
The room is huge and brightly lit. It smells like a zoo. If you stay quiet, you can hear muffled breathing coming from somewhere...

A heavy door leads  to the Experimental Room.

A series of cages line the walls, all open.

There is a small, hand-crafted, wooden maze on a table.

A black cabinet stands near the table.

>enter heavy door
Experimental Room
An intimidatingly large chair sits in the center of the room. The walls are adorned with pictures of random words and drawings. 
 
Northward is an entryway...its door hangs off its hinges, almost completely shattered.

A heavy door leads  to the Lab.

One drawing is not of an object or person and appears to be marked with something.

You realize the quiet breathing from before is from a man sitting in the chair. He does not look at you and wears a blank expression.

>examine drawing
You examine a drawing of a map. It looks to be a map of where you are. Tally marks are drawn under the map in pencil, along with the words "Sebastian Weaver". "That's the map of this facility," the Voice explains. "As you can see, it's not very big. It's rather obscure. Which is what they wanted." 
You wonder who Sebastian Weaver is.

>talk to man
The man does not seem to hear and continues to stare silently at the wall. "He won't respond," the Voice says quietly. "It's a little too late, I'm afraid.

>examine man
A document and photograph are crumpled in the man's hand.

>go north
Maze Room
Giant white walls. It's almost like a human-sized maze. Some blood disturbs the white.

Large holes are on the walls.

Graffiti lines the walls. You can tell from the handwriting that different people had drawn on the walls with markers and pens.

"It's funny," the Voice muses. "They had to do this damn maze all the time and always complained that they wanted to just get out...it took them a while to figure out that they could just break down the walls. They always had the chance to escape."

>go south
Experimental Room
An intimidatingly large chair sits in the center of the room. The walls are adorned with pictures of random words and drawings. 
 
Northward is an entryway...its door hangs off its hinges, almost completely shattered.

A heavy door leads  to the Lab.

One drawing is not of an object or person and appears to be marked with something.

You realize the quiet breathing from before is from a man sitting in the chair. He does not look at you and wears a blank expression.

You can also see a photograph and a document here.

>examine document
It's an official document: 
 
SOMA MEMORY LABS 
143-21 East Drive, SC, CA 
 Date: June 10, 2013 
SUBJECT NAME: 14 (John Akins) 
Age: 43 
Length of Stay: 10 months
 
Subject 14 arrived at the facility as a healthy middle-aged male with average memory skills. He performed well in the maze tasks and made few errors in recollection games. 
After being subjected to the treatment, Subject 14 exhibited gradual memory deterioration, as expected, but at a slower rate than the animals. He made errors in the mazes that he had been trained to do for months. 
By month 4, his short-term memory worsened to a time capacity of roughly 13 seconds. He struggled in recognizing the faces of his experimenters. 
By month 7, he failed to recognize a photo of himself, as well as his family members. 
By month 9, he fiercely demanded to be let out of the facility. We tacitly refused. There is a reason why the experiment went awry, and he is a valuable subject in our attempts to fix the issue. We've been working for years on this project; it's preposterous that the outcome completely counters our goals. For the moment, we will ask him to continue his participation in the memory tasks. Perhaps we may have to expand the types of tasks our subjects perform to get to the heart of the issue. I heard of a suggestion for a human-sized maze. Interesting proposition."

>go north
Maze Room
Giant white walls. It's almost like a human-sized maze. Some blood disturbs the white.

Large holes are on the walls.

Graffiti lines the walls. You can tell from the handwriting that different people had drawn on the walls with markers and pens.

>examine graffiti
Much of the graffiti are angry messages: "WE'RE NOT RATS" 
"YOU MAY MAKE ME FORGET MYSELF, BUT I WON'T FORGET YOUR FACES"

Sylvester walks through the maze with ease and carelessly steps over a tattered folder on the ground.

>examine folder
It contains a bunch of important looking papers. One in particular stands out: 
 
Subject 11519 has been exhibiting the same kind of behavior ever since his treatment. He has been traversing the entire facility, each and every room. Whenever he reaches the Experimental room, he marks the map with a tally mark and his initials. 
The subject had entered the facility as a young man who suffered from severe depression. He came after we advertised under the new motto that the military had told us to take on: "New memory therapy for your mental health." His consent form reveals that his motive for joining our project was to "Be happier." Memory loss can assist this, but we did not reveal to him the grave turnabout of our experiments, the fact that our research was meant to completely annihilate the capability to remember at all.
 
But Subject 11519 persists in his travels. He has indeed exhibited memory deterioration, mostly in the form of amnesiac episodes, but he still walks through the facility, makes his marks, and returns to his cell. He does not want to forget. His supervising experimenter, Dr. John Parr, is interested in his antics and insists that we do not interfere. It's worth noting that he has been acting oddly recently; he does not seem enthusiastic and prefers to keep to himself. If 11519"s behavior begins to pester our research, then we will act accordingly. But for the moment, we will let him be.
 
Note: Humorously enough, he has a travel partner. The damn cat that always manages to escape before we can do anything to him. Perhaps they are both attempting to rebel against us?

"You've been doing well," the Voice suddenly spoke. It sounds quieter than usual. "There is a room up ahead at the end of the maze. Once you're done exploring this area, can you squeeze through the holes and get to the end of the maze?"

>squeeze through holes
A large glass-pane window is on the wall beside a door that is blocked by numerous pieces of furniture, from desk parts, table parts, even comfy chairs. "Ah. Well. Time to think of a solution," the Voice says. "Impress me."

* * *

>examine window
It's made of glass. Hmm...

>break window
Violence isn't the answer to this one.

>smsah window
That's not a verb I recognise.

>smash window
Violence isn't the answer to this one.

>smash window with table leg
You can't see any such thing.

>break window with table leg
You can't see any such thing.

>examine furniture
A giant pile of furniture blocks the door.

Table legs stick out of the pile like spikes.

* * *

>examine drawer compartment
In the drawer compartment are pencils, pens, a stapler and torn papers.

>examine torn papers
 
Entry #5 
Date: October 6, 2016 
Subject 11519...no, Sebastian...has been walking around the facility every day for the past two months. I followed him and saw what he was doing. He was marking his travels. At that moment, I gained clarity. He was attempting to retain his memories. 
I became excited. I told Sebastian to mark his initials as well, instead of just making tally marks. I even let the cat follow him nearly all the times he walked, just as another supplement to his memory retention, a constant in his daily activity. He is the first to exhibit such behavior. And it is subtle enough that no one else would suspect him, of both of us, doing anything.

You see a tape recorder under the papers.

>listen to tape recorder
A voice speaks. It is masculine and sounds bone-weary. The voice sounds somewhat familiar. 
"So they've finally rebelled. At long last. Luckily for me, I expected it. I heard the subjects murmur under their breaths, fall silent when an experimenter walks by. But I heard them. They knew. They figured it out 
They've done a fine job. Made every one of my colleagues run faster than I've ever seen them run. I hid in this room until the storm passed. When I ventured outside, the facility was empty. The test subjects escaped...well, most of them. There is still Subject 46, Edward Baker, and, of course...he must still be around." 
There is a hefty sigh. 
 "It's been two days since the breakout. The military hasn't arrived. If they do, they'll just find me, and two failures of test subjects. Hah. Well, my dear, dear government, how do you like that?" 
You hear the sound of a bottle swishing. The man recording must be drinking something. 
"Regardless...I'm glad. I'm not quite sure what I should do now. I considered burning this place down. Maybe I should. Make it seem like this place never existed...wipe it out of people's memories...heh! After that, I'll go home...yes, I'll go home. And make myself disappear. They can't find me. Nor my family. 
And yet...I linger here. Perhaps I've grown attached to my haven-turned-prison. A bittersweet attachment. No matter. I've stayed here for long enough. I must depart before those uniform-donning dogs arrive. 
Ah...but of course... Yes. My sliver of hope throughout all these months. The resistor. I feel the urge to watch him again...to observe his steady march through the facility...He forgets every time he does it, but he does it every day...like an automaton. 
I think...I will stay. Watch him, for one last time, before I leave this place. But this time, he won't return to his cell. He'll be gone, like the others. I'll make sure of it. 
My name is Doctor John Parr, supervising researcher at Soma Memory Labs. Date...I've lost track. Who cares. This will be my last experimental observation." 
 
 The recorder falls silent. 
 "...Yes. That's it." The Voice sounds faintly approving. "Well done. Do you see that keypad to your right? Why don't you type in the key. You're almost done."

* * *

>examine keypad
There are numbers on the keypad.

"Who are you?" the Voice asks. "What is the key?":

>type 11519
That's not a verb I recognise.

"Who are you?" the Voice asks. "What is the key?":

>tye 11519
That's not a verb I recognise.

"Who are you?" the Voice asks. "What is the key?":

>type 11519
That's not a verb I recognise.

"Who are you?" the Voice asks. "What is the key?":

* * *

>go north
Chamber
A brightly lit room that is white as snow. A large TV sits in the corner, along with a few chairs. Some coffee tables sit nearby. A small camera hangs nearly thirteen feet above you. The floor is spotless.

The camera beeps to life. It swivels and points down to you. You see the lens readjusting, focusing.

Suddenly, the room echoes with the sound of a tinny voice. It sounds somewhat muffled, hidden behind an artificial tone. "Hello. You finally woke up, I see. Hope you had adequate sleep. Can you give me a greeting so I know that you can hear me?"

>gowest
That's not a verb I recognise.

>go west
Equipment Area
The room is entirely trashed. Papers are scattered all over the floor. West is another room, lit in red.

You see some photos that resemble X-rays, but they appear to be burnt.

A deplorable desk is here.

A bedraggled white cat sits snugly on top of a messy desk. A collar is around its neck. It stares at you with beady yellow eyes. The Voice speaks: "That's Sylvester. He's quite a friendly cat. He enjoys a nice touch on the head."

>go west
Red Area
Dozens of photos of men and women alike hang on a wire in the air. To the north you can see an entrance to a brightly lit room.

There is a photo within reach.

Sylvester scampers into the room and looks at you meaningfully. "He seems to take a liking to you," the Voice remarks.

* * *

>go north
Lab
The room is huge and brightly lit. If you stay quiet, you can hear muffled breathing coming from somewhere...

Nearby a heavy door leads east.

A series of cages line the walls, all open.

There is a small, hand-crafted, wooden maze on a table.

A black cabinet stands near the table.

A cockroach sits placidly on the cabinet surface.

Sylvester hisses and begins to sniff eagerly at the cages.

>open cabinet
A key is inside! "Well done," the Voice praises. "You should be able to go on your way."

* * *

>enter heavy door
(first opening the heavy door)

Experimental Room
An intimidatingly large chair sits in the center of the room. The walls are adorned with pictures of words and drawings. 
Up ahead is an entryway...its door hangs off its hinges, almost completely shattered.

Nearby a heavy door leads west to the Lab.

One drawing is not of an object or person.

You realize the quiet breathing from before is from a man sitting in the chair. He does not look at you and wears a blank expression.

>go nort
You can't see any such thing.

>go north
Maze Room
Giant white walls. It's almost like a human-sized maze. Some blood disturbs the white.

Large holes are on the walls.

Graffiti lines the walls. It looks as if different people had written haphazardly on them.

"It's funny," the Voice muses. "They had to do this damn maze all the time and always complained that they wanted to just get out...it took them a while to figure out that they could just break down the walls. They always had the chance to escape."

* * *

>go north
Hallway
A dimly-lit hallway. There is complete darkness to your left and right and you feel a chill at the unsettling emptiness. North is an open entryway.

A gated door leads to the Dark Cell.

>go norht
You can't see any such thing.

>go north
Chamber
A brightly lit room that is white as snow. A large TV sits in the corner, along with a few chairs. Some coffee tables sit nearby. A small camera hangs nearly thirteen feet above you. The floor is spotless.

The camera beeps to life. It swivels and points down to you. You see the lens readjusting, focusing.

Suddenly, the room echoes with the sound of a tinny voice. It sounds somewhat muffled, hidden behind an artificial tone. "Hello. You finally woke up, I see. Hope you had adequate sleep. Can you give me a greeting so I know that you can hear me?"

>go west
Equipment Area
The room is entirely trashed. Papers are scattered all over the gray floor. Westward you can see another room, lit in an ominous red color.

You see some photos that resemble X-rays, but they appear to be burnt.

A deplorable desk is here.

A bedraggled white cat sits snugly on top of a messy desk. A collar is around its neck. It stares at you with beady yellow eyes. 
"That's Sylvester." You jump, startled, as you hear the artificial Voice echo in the room you're in. "He's quite a friendly cat. He enjoys a nice touch on the head."

>go north
You can't go that way.

>go west
Red Room
Dozens of photos of men and women alike, from young to old, hang on a wire in the air. This is a photo-developing room, it seems. To the north you can see an entrance to a brightly lit room.

There is a photo within reach, dangling precariously from a clip on the wire.

Out of the corner of your eye, you see a white mouse nibbling at something near the wall.

>go north
Lab
The room is huge and brightly lit. It smells like a zoo. If you stay quiet, you can hear muffled breathing coming from somewhere...

A heavy door leads east.

A series of cages line the walls, all open.

There is a small, hand-crafted, wooden maze on a table.

A black cabinet stands near the table.

A disgusting brown cockroach sits on top of the cabinet.

Sylvester saunters into the room after you, purring and wearing a rather satisfied look on his face. You can only guess why.

* * *

>unlock heavy door
You unlock the heavy door.

>enter heavy door
(first opening the heavy door)

Experimental Room
An intimidatingly large chair sits in the center of the room. The walls are adorned with pictures of random words and drawings. 
 
Northward is an entryway...its door hangs off its hinges, almost completely shattered.

A heavy door leads  to the Lab.

One drawing in the room is not of an object or person and appears to be marked with something.

You realize the quiet breathing from before is from a man sitting in the chair. He does not look at you and wears a blank expression.

>go north
Maze Room
Giant white walls stand before you, twisting and turning in T shapes. It's almost like a human-sized maze. Some blood disturbs the white.

Large holes are on the walls.

Graffiti lines the walls. You can tell from the handwriting that different people had drawn on the walls with markers and pens.

"It's funny," the Voice muses. "They had to do this damn maze all the time and always complained that they wanted to just get out...it took them a while to figure out that they could just break down the walls. They always had the chance to escape."

* * *

>squeeze through holes
A large glass-pane window is on the wall beside a door that is blocked by numerous pieces of furniture, from desk parts, table parts, even comfy chairs. "Ah. Well. Time to think of a solution," the Voice says. "Impress me."

>kick window
You contemplate breaking the window with your fists, or feet. "Bold, but foolish," the Voice says. "Injuring yourself won't do."

>punch window
Violence isn't the answer to this one.

* * *

>go west
(first opening the yellow door)

Bathroom
A dirty bathroom with an odd smell. The tiles are mucky. You'd rather not stay here for long.

A yellow door leads  to the Dark Cell.

A nasty toilet sits in the corner.

You freeze as you see a long pink tail peering out near the toilet. A large rat is dozing under the toilet bowl.

>examine rat
The rat has its eyes puckered shut. It's fast asleep. Something rectangular is in its mouth. Maybe you can get it to drop it somehow?

>go east
Dark Cell
The air feels oddly heavy. The dark is unsettling. A bed is at the corner. A small window sheds some light so you can navigate around.

A yellow door leads  to the Bathroom.

A gated door leads north.

A small table sits beside the bed.

On the table is a candy bar.

>go north
Hallway
A dimly-lit hallway. There is complete darkness to your left and right and you feel a chill at the unsettling emptiness. North is an open entryway.

A gated door leads  to the Dark Cell.

>go north
Chamber
A brightly lit room that is white as snow. A large TV sits in the corner, along with a few chairs. Some coffee tables sit nearby. A small camera hangs nearly thirteen feet above you. The floor is spotless.

The camera beeps to life. It swivels and points down to you. You see the lens readjusting, focusing.

Suddenly, the room echoes with the sound of a tinny voice. It sounds somewhat muffled, hidden behind an artificial tone. "Hello. You finally woke up, I see. Hope you had adequate sleep. Can you give me a greeting so I know that you can hear me?"

>go west
Equipment Area
The room is entirely trashed. Papers are scattered all over the gray floor. Westward you can see another room, lit in an ominous red color.

You see some photos that resemble X-rays, but they appear to be burnt.

A deplorable desk is here.

On the ground there is a fallen clipboard with some ripped pages.

You can also see cat here.

The cat stares at you with beady yellow eyes. 
"That's Sylvester." You jump, startled, as you hear the artificial Voice echo in the room you're in. "He's quite a friendly cat. He enjoys a nice touch on the head."

>touch cat
Sylvester purres and relaxes under your touch. His collar is right under your hand. Maybe you can take a closer look at it.

>go north
You can't go that way.

>go west
Red Room
Dozens of photos of men and women alike, from young to old, hang on a wire in the air. This is a photo-developing room, it seems. To the north you can see an entrance to a brightly lit room.

There is a photo within reach, dangling precariously from a clip on the wire.

Hanging on the wall is a safelight.

Out of the corner of your eye, you see a white mouse nibbling at something near the wall.

* * *

>enter yellow door
(first opening the yellow door)

Bathroom
A dirty bathroom with an odd smell. The tiles are mucky. You'd rather not stay here for long.

A yellow door leads  to the Dark Cell.

A nasty toilet sits in the corner.

A large rat is dozing under the toilet bowl.

>examine toilet
The water is discolored and the porcelain is nastily yellow. Obviously, plumbing and housecleaning hasn't been around for a while. Nothing exciting and nothing you'd like to see.

[Your score has just gone up by two points.]

>examine rat
The rat has its eyes puckered shut. It's fast asleep. Something rectangular is in its mouth. Maybe you can get it to drop it somehow?

>wake rat
The rat squeals and opens its mouth, dropping a card.

>examine card
A small, dirty, green card. It says the words "REMEMBER" along with the number 11-5-19.

>enter yellow door
Dark Cell
The air feels oddly heavy. The dark is unsettling. A bed is at the corner. A small window sheds some light.

A yellow door leads  to the Bathroom.

A gated door leads north.

>enter gated door
Hallway
A dimly-lit hallway. There is complete darkness to your left and right and you feel a chill at the unsettling emptiness. North is an open entryway.

A gated door leads  to the Dark Cell.

>go north
Chamber
A brightly lit room that is white as snow. A large TV sits in the corner, along with a few chairs. Some coffee tables sit nearby. A small camera hangs nearly thirteen feet above you. The floor is spotless.

The camera beeps to life. It swivels and points down to you. You see the lens readjusting, focusing.

Suddenly, the room echoes with the sound of a tinny voice. It sounds somewhat muffled, hidden behind an artificial tone. "Hello. You finally woke up, I see. Hope you had adequate sleep. Can you give me a greeting so I know that you can hear me?"

* * *

>greet voice
The camera whirs. "Fantastic. I'll be watching you progress through this place. You want to explore, no? Now go to your left. There's a room there."

>go left
Equipment Area
The room is entirely trashed. Papers are scattered all over the gray floor. Westward you can see another room, lit in an ominous red color.

You see some photos that resemble X-rays, but they appear to be burnt.

A deplorable desk is here.

A bedraggled white cat sits snugly on top of a messy desk. A collar is around its neck. It stares at you with beady yellow eyes. The Voice speaks: "That's Sylvester. He's quite a friendly cat. He enjoys a nice touch on the head."

Curious, eh?" You jump, startled, as you hear the artificial Voice in the very room you're in. "Like I said, I'll be watching you. Explore as much as you like around here." There's a short pause. "No one will stop you."

>touch Sylvester
Sylvester seems relaxed and complacent. The collar is right under your hand. Maybe you can take a closer look at it.

* * *

>examine collar
It has the letters "--MORY LABS." Some letters are blurred out. The initials "S.W." are scrawled on it.

[Your score has just gone up by five points.]

>go west
Red Room
Dozens of photos of men and women alike, from young to old, hang on a wire in the air. This is a photo-developing room, it seems. To the north you can see an entrance to a brightly lit room.

There is a photo within reach.

>take photo
Taken.

>examine photo
This photo shows two people sitting at a table in a simple room. One person wears a white coat, his back to the camera. The other, a middle-aged woman, stares at him with an unnaturally blank look. On the bottom of the photo is a message: "Subject 46: Exhibiting failure to recognize her experimenter of 10 months."

[Your score has just gone up by five points.]

>go west
You can't go that way.

>go north
Lab
The room is huge and brightly lit. If you stay quiet, you can hear muffled breathing coming from somewhere...

A heavy door leads east.

A series of cages line the walls, all open.

There is a small, hand-crafted, wooden maze on a table.

A black cabinet stands near the table.

A cockroach sits placidly on the cabinet surface.

Sylvester meows and begins to sniff eagerly at the cages.

>open cabinet
The cockroach seems to be staring straight into your soul, and you get the worst goosebumps. "You are quite amusing," the Voice speaks. "I won't judge you."

* * *

>examine candy bar
It's still wrapped. It's peanut butter chocolate.

>eat candy bar
(first taking the candy bar)
You aren't particularly hungry, but you unwrap the candy bar and eat it. The chocolate is just the right amount of sweet. You gain some much needed, post-sleep energy.

[Your score has just gone up by two points.]

>examine candy bar
You can't see any such thing.

>go west
(first opening the yellow door)

Bathroom
A dirty bathroom with an odd smell. The tiles are mucky. You'd rather not stay here for long.

A yellow door leads  to the Dark Cell.

A nasty toilet sits in the corner.

A large rat is dozing under the toilet bowl.

>examine rat
The rat has its eyes puckered shut. It's fast asleep. Something rectangular is in its mouth. Maybe you can get it to drop it somehow?

>wake rat
The rat squeals and opens its mouth, dropping a card. It scurries away in a mad dash to some obscure place.

[Your score has just gone up by five points.]

>examine card
A small, dirty, green card. It seems to be a business card, but the logo is smudged with something. Written in marker is the word REMEMBER" along with the number 11-5-19. The numbers don't mean anything to you. Who wrote on the card?

>enter bathroom door
You can't see any such thing.

>enter yellow door
Dark Cell
The air feels oddly heavy. The dark is unsettling. A bed is at the corner. A small window sheds some light so you can navigate around.

A yellow door leads  to the Bathroom.

A gated door leads north.

A small table sits beside the bed.

>examine table
You see nothing special about the table.

>go north
Hallway
A dimly-lit hallway. There is complete darkness to your left and right and you feel a chill at the unsettling emptiness. North is an open entryway.

A gated door leads  to the Dark Cell.

* * *

>eat candy bar
(first taking the candy bar)
You aren't particularly hungry, but you unwrap the candy bar and eat it. The chocolate is just the right amount of sweet. You gain some much needed, post-sleep energy.

[Your score has just gone up by two points.]

>go north
Hallway
A dimly-lit hallway. There is complete darkness to your left and right and you feel a chill at the unsettling emptiness. North is an open entryway.

A gated door leads  to the Dark Cell.

* * *

>touch cat
Sylvester purres and relaxes under your touch. His collar is right under your hand. Maybe you can take a closer look at it.

>examine Sylvester
The cat stares at you with wide, expressionless eyes. "They say if you stare at a cat for more than five seconds, it'll attack you," the Voice offers. You quickly turn your head away before anything can happen.

>examine collar
It has the letters "--MORY LABS." Some letters are blurred out. The initials "S.W." are scrawled on it.

[Your score has just gone up by five points.]

>examine clipboard
Many of the pages are ripped out. You can make out some sentences on same pages: 
"--exhibiting extraordinary d--" 
"--comprehension skills" 
"--void outcome." 
 Your fingers graze something on the back of the clipboard.

>flip clipboard over
You turn the clipboard over and see a message carved into the wooden surface: 
"Wrong. Wrong. All wrongwrongwrong."

[Your score has just gone up by three points.]

>go north
You can't go that way.

* * *

>go west
Red Room
Dozens of photos of men and women alike, from young to old, hang on a wire in the air. This is a photo-developing room, it seems. To the north you can see an entrance to a brightly lit room.

There is a photo within reach, dangling precariously from a clip on the wire.

Hanging on the wall is a safelight.

Out of the corner of your eye, you see a white mouse nibbling at something near the wall.

>examine mouse
It has something in its paws...your feline friend hasn't noticed it yet. Sylvester's too busy grooming his fur. Perhaps if you gestured at the mouse...

>point at mouse
You nudge Sylvester with your foot, earning a growl as he leers at you over his shoulders. You quickly stab a finger at the mouse, and Sylvester's eyes widen and he immediately goes into a crouch, stalking rapidly towards the mouse. You turn away, and after a few seconds, see Sylvester silently walk away. The mouse is gone. What seems to be a brochure is on the ground where it was...

[Your score has just gone up by five points.]

>read brochure
It's been bitten through badly, but on the cover you can make out a picture of a nice-looking, white building. Inside, you can read some of the words: "new technology--breakthr--gh treatment--mem--". 
 It's hopeless. The mouse had done a thorough job making the brochure unreadable.

>go west
You can't go that way.

>turn on safelight
You turn on the safelight. It emits a dim glow and shines down on a countertop covered in photos. They're half-developed and you can only catch a glimpse of some figures in the photos: all appear to be in the presence of some white-coated individual.

[Your score has just gone up by three points.]

* * *

>turn on safelight
The safelight is already on.

>go north
Lab
The room is huge and brightly lit. It smells like a zoo. If you stay quiet, you can hear muffled breathing coming from somewhere...

A heavy door leads east.

A series of cages line the walls, all open.

There is a small, hand-crafted, wooden maze on a table.

A black cabinet stands near the table.

A disgusting brown cockroach sits on top of the cabinet.

Sylvester saunters into the room after you, purring and wearing a rather satisfied look on his face. You can only guess why.